ACS,Kills,Deaths,Assists,Difference,KAST,ADR,HS,FK,FD,Diff
365,47,20,9,27,84%,213,17%,12,5,7
66,1,14,4,-13,47%,64,13%,0,4,-4
69,10,46,15,-36,56%,44,23%,1,4,-3
69,22,36,9,-14,67%,50,29%,1,5,-4
70,4,15,1,-11,42%,46,9%,0,7,-7
73,5,14,5,-9,75%,53,15%,0,1,-1
82,5,16,2,-11,40%,63,23%,0,2,-2
83,9,26,6,-17,58%,58,22%,1,3,-2
85,18,34,17,-16,69%,73,28%,1,2,-1
87,7,15,6,-8,78%,58,44%,0,2,-2
91,7,18,5,-11,65%,67,25%,1,2,-1
91,5,13,4,-8,47%,67,50%,0,2,-2
93,10,32,14,-22,58%,56,23%,2,3,-1
93,6,16,3,-10,55%,56,9%,0,3,-3
93,13,35,12,-22,52%,65,20%,2,8,-6
94,7,28,9,-21,43%,73,12%,0,4,-4
94,14,31,9,-17,60%,69,18%,2,6,-4
95,7,25,8,-18,47%,73,16%,0,1,-1
95,15,27,11,-12,70%,77,21%,1,9,-8
98,7,19,1,-12,50%,71,39%,4,2,2
99,22,25,11,-3,74%,69,15%,4,2,2
103,11,30,9,-19,50%,67,20%,0,5,-5
103,15,35,13,-20,63%,76,40%,1,2,-1
104,7,15,0,-8,50%,69,20%,3,4,-1
105,27,31,1,-4,69%,79,26%,3,3,0
105,14,33,4,-19,36%,74,13%,0,11,-11
105,10,32,12,-22,50%,72,10%,0,6,-6
106,14,34,10,-20,53%,62,24%,0,0,0
106,7,15,0,-8,73%,74,19%,0,4,-4
106,11,23,6,-12,53%,71,31%,1,6,-5
106,9,31,12,-22,53%,71,23%,0,9,-9
106,34,29,8,5,86%,80,29%,3,0,3
107,14,29,2,-15,60%,75,28%,1,6,-5
107,13,31,8,-18,49%,73,28%,0,3,-3
108,13,37,18,-24,53%,71,13%,3,5,-2
109,14,34,13,-20,60%,78,15%,2,7,-5
109,20,41,23,-21,73%,72,27%,2,6,-4
109,11,29,5,-18,45%,83,41%,0,4,-4
110,17,31,10,-14,57%,74,40%,1,5,-4
112,17,21,4,-4,69%,74,35%,2,7,-5
113,8,14,3,-6,67%,85,43%,2,3,-1
113,14,31,8,-17,56%,73,23%,0,5,-5
113,26,33,3,-7,69%,87,27%,2,5,-3
114,7,17,2,-10,47%,72,38%,0,6,-6
115,17,29,10,-12,57%,71,15%,1,3,-2
115,12,27,5,-15,38%,75,17%,2,3,-1
115,13,31,4,-18,41%,90,18%,1,4,-3
115,18,33,10,-15,63%,80,19%,0,3,-3
116,8,14,2,-6,50%,82,33%,0,1,-1
117,21,45,11,-24,64%,76,6%,4,6,-2
117,12,25,11,-13,56%,83,19%,0,2,-2
117,11,28,4,-17,45%,73,24%,1,4,-3
118,17,31,6,-14,61%,70,24%,3,6,-3
118,15,20,11,-5,66%,68,23%,4,4,0
119,15,28,9,-13,67%,80,26%,1,1,0
120,9,28,4,-19,42%,85,20%,1,5,-4
120,15,32,14,-17,59%,86,16%,2,2,0
120,20,46,11,-26,46%,82,22%,3,6,-3
122,15,34,14,-19,58%,78,12%,1,5,-4
122,14,30,4,-16,58%,80,46%,1,2,-1
123,17,35,14,-18,60%,86,22%,1,2,-1
123,14,31,4,-17,44%,91,23%,2,4,-2
123,16,32,10,-16,50%,88,15%,4,4,0
123,26,49,22,-23,60%,82,25%,2,13,-11
123,14,31,4,-17,51%,84,38%,2,12,-10
123,7,17,4,-10,45%,92,25%,1,2,-1
124,14,32,8,-18,57%,92,25%,5,4,1
124,17,33,6,-16,54%,85,56%,4,6,-2
124,19,23,11,-4,71%,90,30%,2,4,-2
125,26,43,15,-17,62%,89,25%,1,6,-5
125,27,40,11,-13,67%,71,32%,2,3,-1
126,14,31,8,-17,54%,88,23%,2,5,-3
126,15,30,15,-15,69%,100,20%,2,3,-1
126,17,31,15,-14,71%,93,21%,3,3,0
127,15,27,9,-12,76%,88,11%,3,3,0
127,27,50,12,-23,62%,84,31%,2,8,-6
127,21,31,5,-10,67%,83,31%,3,0,3
128,16,30,7,-14,60%,85,19%,1,4,-3
128,9,15,3,-6,60%,99,23%,2,5,-3
128,23,41,11,-18,60%,83,34%,4,8,-4
128,14,26,11,-12,68%,88,14%,2,2,0
128,21,32,14,-11,56%,85,25%,2,1,1
129,19,30,7,-11,51%,76,28%,1,1,0
129,17,29,17,-12,64%,89,28%,0,1,-1
129,20,36,12,-16,56%,79,17%,1,1,0
129,14,27,3,-13,52%,97,23%,3,3,0
129,15,34,4,-19,50%,81,18%,1,8,-7
129,16,30,3,-14,46%,89,28%,1,4,-3
129,8,15,9,-7,62%,90,20%,0,2,-2
129,15,32,8,-17,46%,93,29%,0,6,-6
129,25,50,19,-25,58%,98,15%,1,5,-4
129,18,38,7,-20,57%,87,25%,0,5,-5
130,16,33,14,-17,76%,84,18%,1,5,-4
130,20,30,13,-10,62%,91,25%,3,9,-6
130,19,37,8,-18,65%,93,29%,2,3,-1
130,16,33,14,-17,76%,84,18%,1,5,-4
130,15,31,6,-16,50%,95,25%,1,1,0
130,8,16,7,-8,57%,103,26%,0,5,-5
130,17,25,8,-8,66%,94,25%,0,4,-4
130,8,9,7,-1,78%,90,27%,0,4,-4
130,11,28,6,-17,47%,94,19%,3,7,-4
130,23,48,22,-25,66%,90,23%,3,6,-3
131,16,28,8,-12,54%,91,25%,1,4,-3
131,17,21,11,-4,68%,79,18%,2,0,2
131,23,39,15,-16,57%,94,26%,1,6,-5
131,21,27,14,-6,66%,85,18%,3,2,1
132,26,27,12,-1,80%,96,35%,3,4,-1
132,13,18,9,-5,79%,90,19%,0,0,0
132,15,33,7,-18,53%,86,30%,1,3,-2
132,41,59,19,-18,66%,99,26%,3,9,-6
132,16,32,4,-16,55%,92,27%,0,8,-8
132,16,28,5,-12,56%,107,18%,2,4,-2
132,31,43,11,-12,69%,95,21%,2,8,-6
132,18,34,12,-16,65%,89,28%,1,4,-3
133,21,35,9,-14,61%,88,17%,1,5,-4
133,15,34,13,-19,58%,88,20%,1,2,-1
133,14,30,6,-16,51%,96,14%,2,3,-1
133,16,33,6,-17,57%,91,25%,3,1,2
133,28,54,22,-26,73%,96,13%,5,3,2
133,16,33,7,-17,50%,89,24%,3,6,-3
133,12,15,5,-3,63%,96,23%,1,3,-2
134,19,39,11,-20,66%,87,14%,1,7,-6
134,18,38,3,-20,46%,88,29%,3,6,-3
134,15,26,2,-11,63%,85,24%,2,3,-1
134,17,32,6,-15,58%,100,37%,0,3,-3
135,29,49,17,-20,68%,97,29%,3,8,-5
135,9,16,3,-7,52%,92,29%,3,4,-1
135,8,15,8,-7,81%,95,18%,0,1,-1
135,26,29,10,-3,61%,85,27%,3,4,-1
135,27,36,11,-9,58%,98,15%,1,6,-5
135,12,28,12,-16,63%,94,24%,2,4,-2
135,21,31,10,-10,65%,96,47%,2,0,2
136,18,32,23,-14,64%,90,19%,1,5,-4
136,20,31,6,-11,60%,92,14%,1,4,-3
136,19,33,6,-14,56%,95,44%,1,5,-4
136,20,30,12,-10,59%,87,43%,3,1,2
136,9,21,18,-12,65%,95,25%,2,6,-4
136,8,12,8,-4,68%,97,14%,2,2,0
136,13,26,5,-13,55%,97,21%,3,5,-2
136,28,49,14,-21,55%,95,12%,3,5,-2
137,17,32,11,-15,58%,94,26%,0,2,-2
137,24,33,13,-9,67%,91,25%,3,2,1
137,16,31,6,-15,61%,91,23%,3,3,0
137,14,31,9,-17,61%,102,29%,2,4,-2
137,30,54,20,-24,62%,91,23%,3,10,-7
137,18,29,4,-11,56%,88,15%,5,4,1
137,14,15,6,-1,54%,91,28%,1,3,-2
137,8,16,4,-8,56%,99,8%,0,2,-2
137,32,57,18,-25,62%,102,35%,3,4,-1
138,32,38,12,-6,78%,91,20%,2,1,1
138,8,16,6,-8,71%,95,21%,1,1,0
138,12,16,0,-4,67%,88,28%,2,3,-1
138,14,26,6,-12,50%,85,20%,1,4,-3
139,18,31,9,-13,66%,101,18%,2,5,-3
139,16,31,10,-15,61%,93,27%,2,6,-4
139,17,31,8,-14,55%,97,16%,2,2,0
139,18,18,12,0,87%,85,11%,1,3,-2
139,29,42,18,-13,64%,96,16%,2,3,-1
139,21,25,6,-4,69%,101,25%,2,6,-4
139,11,16,1,-5,68%,78,5%,0,0,0
139,27,35,29,-8,71%,87,27%,0,3,-3
140,22,36,6,-14,59%,101,33%,5,6,-1
140,12,16,0,-4,65%,86,21%,1,3,-2
140,12,21,9,-9,57%,105,31%,1,3,-2
140,20,35,7,-15,59%,97,19%,3,11,-8
140,29,55,34,-26,67%,109,22%,0,7,-7
140,51,82,30,-31,70%,84,25%,8,8,0
140,20,31,5,-11,59%,99,33%,2,3,-1
140,36,55,32,-19,74%,94,11%,4,8,-4
140,31,51,8,-20,52%,91,18%,2,5,-3
140,18,25,5,-7,60%,92,19%,0,2,-2
140,54,78,22,-24,68%,99,28%,5,12,-7
140,17,34,10,-17,59%,96,27%,1,6,-5
140,20,33,16,-13,71%,89,27%,1,4,-3
141,25,43,13,-18,63%,87,11%,1,2,-1
141,12,36,12,-24,45%,104,8%,3,9,-6
141,18,33,8,-15,62%,93,27%,3,3,0
141,10,12,9,-2,53%,74,28%,1,1,0
141,8,17,6,-9,62%,94,13%,1,3,-2
141,22,36,12,-14,64%,107,23%,1,3,-2
141,21,31,8,-10,70%,98,33%,3,5,-2
142,32,39,13,-7,75%,94,30%,5,2,3
142,26,28,3,-2,55%,108,33%,2,7,-5
142,37,26,8,11,83%,103,43%,6,5,1
142,28,49,12,-21,52%,90,20%,6,15,-9
143,21,23,17,-2,82%,89,22%,0,3,-3
143,21,33,9,-12,60%,98,29%,2,1,1
143,18,24,9,-6,77%,85,10%,1,1,0
143,23,29,4,-6,71%,102,43%,1,3,-2
143,17,33,6,-16,69%,96,25%,3,5,-2
143,29,42,12,-13,69%,95,26%,3,4,-1
144,34,51,18,-17,71%,97,40%,5,5,0
144,32,39,17,-7,71%,99,25%,4,6,-2
144,19,28,5,-9,49%,87,32%,1,3,-2
144,13,17,6,-4,73%,97,26%,2,4,-2
144,20,35,12,-15,61%,95,26%,1,2,-1
144,20,30,10,-10,70%,96,26%,1,3,-2
144,19,33,5,-14,56%,109,26%,3,3,0
144,42,65,22,-23,65%,95,29%,3,10,-7
144,20,28,5,-8,51%,102,27%,2,9,-7
144,19,29,5,-10,46%,101,29%,3,2,1
144,26,43,9,-17,61%,105,30%,2,5,-3
144,24,32,10,-8,65%,106,21%,3,9,-6
145,20,26,15,-6,70%,93,24%,3,2,1
145,20,26,15,-6,70%,93,24%,3,2,1
145,18,32,4,-14,50%,104,28%,1,6,-5
145,20,26,13,-6,74%,91,25%,4,1,3
145,16,23,23,-7,86%,96,16%,1,4,-3
145,11,15,9,-4,75%,100,23%,1,1,0
145,21,36,8,-15,62%,110,23%,1,3,-2
146,21,31,14,-10,73%,101,18%,2,2,0
146,16,33,6,-17,53%,95,15%,1,6,-5
146,13,12,6,1,86%,102,41%,0,1,-1
146,24,27,8,-3,69%,95,28%,2,5,-3
146,17,33,3,-16,51%,102,29%,5,7,-2
146,22,33,15,-11,62%,89,21%,2,6,-4
146,33,50,22,-17,68%,92,31%,4,4,0
146,25,42,9,-17,57%,87,21%,4,3,1
147,23,38,2,-15,55%,101,36%,6,12,-6
147,32,50,14,-18,67%,105,18%,8,3,5
147,21,35,11,-14,67%,102,25%,2,2,0
147,23,38,2,-15,55%,101,36%,6,12,-6
147,58,86,25,-28,68%,106,35%,5,16,-11
147,18,29,3,-11,50%,104,25%,4,4,0
147,14,19,4,-5,71%,99,38%,0,2,-2
147,10,9,4,1,68%,93,32%,3,1,2
147,36,23,14,13,90%,97,39%,1,1,0
147,13,16,5,-3,67%,98,27%,1,3,-2
147,22,33,6,-11,67%,98,31%,3,2,1
147,31,47,21,-16,70%,99,22%,4,5,-1
147,39,49,9,-10,54%,106,25%,2,13,-11
147,21,28,13,-7,67%,118,30%,0,3,-3
147,12,10,5,2,70%,88,38%,0,1,-1
148,23,30,11,-7,70%,95,22%,1,3,-2
148,23,30,11,-7,70%,95,22%,1,3,-2
148,28,38,11,-10,67%,103,31%,4,7,-3
148,35,42,14,-7,68%,99,20%,1,3,-2
148,32,44,20,-12,64%,101,25%,2,4,-2
148,18,30,10,-12,55%,97,16%,2,4,-2
148,20,36,6,-16,54%,116,35%,5,4,1
148,23,32,10,-9,62%,102,17%,5,7,-2
148,33,43,27,-10,79%,92,14%,5,5,0
148,26,44,15,-18,59%,96,26%,3,3,0
148,38,63,11,-25,64%,96,28%,11,14,-3
148,20,32,13,-12,71%,100,12%,4,3,1
148,21,22,18,-1,73%,96,23%,1,0,1
148,23,31,3,-8,56%,107,38%,3,7,-4
148,18,34,8,-16,54%,100,26%,3,6,-3
148,21,35,7,-14,51%,110,21%,3,7,-4
148,23,31,7,-8,53%,105,23%,4,0,4
148,33,49,15,-16,63%,103,36%,6,8,-2
149,35,49,15,-14,62%,103,31%,4,7,-3
149,21,31,6,-10,67%,100,35%,2,5,-3
149,42,56,28,-14,68%,99,26%,1,4,-3
149,20,18,12,2,72%,97,39%,0,2,-2
149,18,32,6,-14,56%,95,29%,2,3,-1
149,32,46,24,-14,59%,92,41%,4,5,-1
149,30,43,28,-13,65%,103,24%,3,4,-1
150,22,34,13,-12,63%,103,22%,6,6,0
150,35,55,21,-20,73%,97,31%,5,10,-5
150,18,35,15,-17,63%,106,15%,3,5,-2
150,35,41,13,-6,65%,103,19%,1,1,0
150,17,14,11,3,81%,100,22%,3,1,2
150,48,61,25,-13,72%,90,21%,4,6,-2
150,27,46,18,-19,67%,108,15%,3,8,-5
150,33,49,12,-16,59%,106,20%,5,6,-1
150,17,16,11,1,83%,105,30%,1,0,1
151,35,46,16,-11,72%,96,14%,4,5,-1
151,14,20,1,-6,62%,92,30%,4,1,3
151,23,34,8,-11,57%,101,32%,6,5,1
151,11,20,6,-9,50%,103,19%,3,1,2
151,21,20,9,1,77%,96,48%,3,1,2
151,20,34,10,-14,51%,106,20%,1,4,-3
151,15,20,10,-5,67%,101,22%,3,5,-2
151,10,19,4,-9,55%,102,33%,5,2,3
151,29,30,22,-1,81%,96,13%,5,3,2
152,26,34,5,-8,61%,94,34%,5,1,4
152,33,48,25,-15,73%,108,22%,3,7,-4
152,21,31,15,-10,69%,127,26%,1,3,-2
152,19,28,9,-9,56%,111,26%,1,4,-3
152,23,27,13,-4,76%,95,19%,2,6,-4
152,39,51,13,-12,67%,111,31%,7,15,-8
152,21,32,9,-11,62%,110,23%,2,4,-2
152,25,44,12,-19,59%,98,24%,4,3,1
152,29,35,17,-6,67%,98,23%,2,3,-1
152,12,16,7,-4,67%,111,48%,1,0,1
152,18,32,13,-14,61%,104,18%,1,3,-2
152,11,17,5,-6,57%,100,29%,0,4,-4
152,29,42,11,-13,59%,107,24%,2,3,-1
153,37,50,15,-13,59%,101,28%,7,11,-4
153,23,35,10,-12,57%,107,34%,3,3,0
153,33,39,11,-6,71%,109,27%,2,2,0
153,24,21,13,3,68%,103,21%,4,2,2
153,21,30,14,-9,79%,108,33%,4,2,2
153,19,30,15,-11,67%,106,27%,4,5,-1
153,12,15,1,-3,48%,103,35%,2,5,-3
153,35,56,19,-21,63%,106,25%,3,6,-3
153,20,32,8,-12,56%,95,24%,0,3,-3
154,29,42,18,-13,71%,108,25%,4,2,2
154,26,18,3,8,71%,111,26%,0,3,-3
154,21,40,15,-19,58%,108,34%,2,7,-5
154,24,30,2,-6,69%,114,55%,1,4,-3
154,9,13,5,-4,70%,106,20%,0,1,-1
154,18,24,10,-6,86%,102,17%,4,3,1
154,21,19,10,2,68%,108,23%,1,3,-2
154,34,53,24,-19,73%,96,18%,7,11,-4
154,26,41,8,-15,69%,113,19%,3,2,1
154,32,41,13,-9,77%,105,39%,5,6,-1
155,24,31,14,-7,67%,101,23%,1,4,-3
155,22,23,13,-1,78%,108,19%,3,1,2
155,21,31,10,-10,70%,99,24%,3,6,-3
155,24,33,10,-9,51%,119,28%,4,3,1
155,21,32,7,-11,67%,107,39%,5,4,1
155,14,15,3,-1,64%,91,33%,1,1,0
155,22,30,6,-8,74%,111,30%,1,4,-3
155,20,20,12,0,74%,114,16%,0,2,-2
156,21,17,15,4,86%,93,20%,2,3,-1
156,23,31,4,-8,50%,108,27%,2,7,-5
156,20,35,6,-15,55%,102,13%,4,9,-5
156,22,30,6,-8,47%,114,14%,2,7,-5
156,13,13,5,0,73%,107,24%,0,2,-2
156,39,49,16,-10,68%,104,29%,3,4,-1
156,20,34,6,-14,64%,100,25%,6,10,-4
156,24,33,15,-9,76%,93,28%,5,6,-1
156,19,29,7,-10,62%,109,29%,3,3,0
156,24,37,13,-13,62%,100,31%,1,6,-5
156,22,29,4,-7,61%,105,19%,4,5,-1
156,20,35,12,-15,62%,105,22%,5,5,0
156,35,44,12,-9,71%,103,27%,6,7,-1
156,19,30,10,-11,64%,111,29%,1,2,-1
156,20,30,6,-10,55%,98,22%,3,2,1
157,40,56,28,-16,63%,100,32%,2,12,-10
157,39,56,16,-17,64%,102,32%,9,13,-4
157,11,14,4,-3,62%,102,37%,0,4,-4
157,32,42,20,-10,67%,106,21%,3,3,0
157,21,36,7,-15,62%,111,21%,4,8,-4
157,21,25,10,-4,80%,111,29%,1,1,0
157,23,33,8,-10,67%,105,23%,2,5,-3
157,16,30,13,-14,62%,103,22%,1,2,-1
157,44,47,17,-3,64%,100,28%,1,12,-11
158,29,42,14,-13,60%,107,21%,2,5,-3
158,17,30,8,-13,61%,102,27%,3,1,2
158,12,14,1,-2,57%,99,22%,2,3,-1
158,22,31,3,-9,54%,94,22%,2,4,-2
158,13,14,6,-1,75%,107,29%,2,2,0
158,18,29,7,-11,66%,112,34%,1,0,1
158,35,40,3,-5,52%,107,35%,5,4,1
158,39,35,10,4,79%,112,30%,1,4,-3
158,59,70,47,-11,71%,101,24%,5,4,1
158,27,25,8,2,70%,102,28%,1,2,-1
158,28,45,15,-17,58%,117,28%,3,9,-6
158,34,45,15,-11,61%,102,25%,6,7,-1
158,23,26,14,-3,64%,109,43%,3,2,1
158,12,18,4,-6,71%,105,21%,0,2,-2
159,17,35,7,-18,50%,116,27%,6,4,2
159,21,20,12,1,75%,111,25%,2,4,-2
159,12,15,13,-3,82%,115,33%,1,0,1
159,19,24,14,-5,74%,117,18%,3,2,1
159,62,75,18,-13,63%,110,34%,2,8,-6
159,30,36,26,-6,70%,103,21%,4,1,3
159,18,36,9,-18,55%,114,20%,4,7,-3
160,29,35,18,-6,77%,106,28%,6,3,3
160,17,24,8,-7,67%,110,22%,0,4,-4
160,20,22,15,-2,74%,108,20%,2,3,-1
160,23,30,11,-7,70%,116,30%,1,1,0
160,16,27,8,-11,44%,102,28%,3,6,-3
160,20,33,7,-13,58%,106,26%,4,4,0
160,24,28,8,-4,66%,103,41%,2,2,0
160,18,26,11,-8,63%,107,25%,2,3,-1
160,17,25,3,-8,60%,103,13%,2,2,0
161,31,28,17,3,71%,109,29%,2,2,0
161,27,26,15,1,70%,109,20%,2,5,-3
161,25,27,7,-2,76%,109,21%,1,3,-2
161,35,43,23,-8,67%,108,26%,0,5,-5
161,22,20,8,2,76%,113,38%,4,4,0
161,23,32,7,-9,55%,106,20%,4,5,-1
161,37,46,28,-9,79%,112,33%,0,2,-2
161,14,18,6,-4,76%,92,30%,1,3,-2
161,21,32,4,-11,58%,99,47%,6,8,-2
161,23,26,16,-3,79%,108,17%,1,2,-1
161,38,49,23,-11,67%,109,22%,6,4,2
161,23,22,4,1,82%,115,26%,3,6,-3
161,31,47,16,-16,63%,112,22%,1,5,-4
162,38,37,25,1,73%,118,23%,2,3,-1
162,35,51,21,-16,55%,99,14%,5,7,-2
162,24,29,13,-5,66%,113,18%,1,1,0
162,22,17,13,5,80%,111,23%,0,1,-1
162,39,51,13,-12,65%,111,18%,4,7,-3
162,24,32,16,-8,70%,117,33%,3,3,0
162,56,76,19,-20,62%,114,22%,6,17,-11
162,35,45,18,-10,59%,122,25%,4,4,0
162,32,48,7,-16,61%,116,25%,10,11,-1
163,33,41,21,-8,72%,112,30%,0,2,-2
163,24,32,12,-8,75%,107,26%,3,5,-2
163,23,30,15,-7,69%,111,28%,1,4,-3
163,28,33,5,-5,73%,103,17%,6,2,4
163,43,43,17,0,70%,109,33%,6,4,2
163,24,35,14,-11,62%,117,23%,4,2,2
163,36,46,20,-10,57%,111,18%,1,4,-3
163,23,35,4,-12,57%,113,33%,2,9,-7
163,40,49,11,-9,66%,104,37%,5,11,-6
163,33,41,16,-8,67%,105,14%,3,9,-6
164,23,29,15,-6,68%,126,34%,2,2,0
164,25,44,24,-19,67%,114,25%,4,9,-5
164,27,33,11,-6,72%,109,35%,5,6,-1
164,25,18,14,7,83%,103,24%,4,2,2
164,34,45,19,-11,69%,111,16%,3,9,-6
164,13,16,12,-3,77%,120,15%,1,1,0
164,18,33,10,-15,64%,122,15%,5,5,0
164,38,52,21,-14,74%,108,16%,8,8,0
164,47,62,13,-15,68%,112,24%,6,5,1
164,22,21,8,1,69%,119,25%,2,4,-2
164,25,34,16,-9,60%,100,30%,4,6,-2
164,37,41,14,-4,63%,103,28%,4,5,-1
164,12,17,4,-5,48%,112,25%,1,1,0
165,21,25,12,-4,68%,97,23%,2,3,-1
165,13,15,2,-2,67%,115,54%,0,0,0
165,36,47,14,-11,61%,113,22%,6,7,-1
165,23,29,9,-6,71%,114,30%,3,4,-1
165,41,57,20,-16,63%,107,19%,5,12,-7
165,33,48,15,-15,69%,111,25%,5,7,-2
165,40,52,30,-12,69%,111,25%,7,11,-4
165,35,43,11,-8,68%,115,27%,5,3,2
165,28,40,17,-12,63%,102,20%,3,5,-2
165,24,31,7,-7,56%,114,25%,3,8,-5
165,57,75,36,-18,72%,107,29%,13,14,-1
165,26,35,13,-9,66%,113,33%,4,9,-5
165,33,35,14,-2,66%,111,15%,2,4,-2
166,22,31,12,-9,60%,120,22%,4,7,-3
166,20,33,8,-13,53%,105,22%,3,9,-6
166,24,29,8,-5,58%,112,31%,2,4,-2
166,22,30,4,-8,51%,114,25%,2,4,-2
166,24,33,5,-9,50%,109,22%,3,8,-5
166,27,30,20,-3,83%,115,32%,4,3,1
166,22,28,11,-6,61%,120,27%,2,4,-2
166,21,20,12,1,72%,101,14%,1,4,-3
166,12,12,5,0,89%,91,37%,2,1,1
166,25,28,11,-3,71%,106,32%,3,2,1
166,28,28,8,0,69%,102,26%,4,3,1
166,23,30,8,-7,66%,115,27%,4,5,-1
166,13,16,6,-3,81%,117,42%,2,4,-2
166,21,36,7,-15,59%,111,29%,2,5,-3
166,38,57,24,-19,70%,104,26%,6,11,-5
167,25,33,8,-8,64%,108,23%,1,7,-6
167,21,31,8,-10,62%,104,28%,1,1,0
167,23,35,16,-12,66%,112,36%,2,4,-2
167,24,31,6,-7,70%,112,31%,2,5,-3
167,30,46,23,-16,66%,113,23%,8,4,4
167,22,19,9,3,86%,125,23%,4,0,4
167,25,32,3,-7,55%,103,28%,4,3,1
167,19,29,8,-10,49%,116,20%,3,6,-3
167,24,30,6,-6,59%,112,25%,3,1,2
167,41,56,31,-15,77%,117,19%,5,6,-1
167,12,14,3,-2,57%,135,33%,0,1,-1
167,40,29,10,11,88%,114,21%,5,0,5
167,9,6,7,3,87%,118,21%,0,0,0
167,60,63,23,-3,71%,118,23%,4,8,-4
167,34,46,16,-12,65%,112,24%,4,5,-1
167,28,42,10,-14,64%,114,20%,9,5,4
167,40,36,6,4,70%,110,23%,6,7,-1
168,21,29,15,-8,62%,116,29%,0,2,-2
168,25,28,16,-3,75%,118,34%,5,5,0
168,25,28,16,-3,75%,118,34%,5,5,0
168,21,29,15,-8,62%,116,29%,0,2,-2
168,38,55,19,-17,69%,111,21%,4,5,-1
168,37,30,11,7,75%,114,24%,3,2,1
168,43,47,25,-4,65%,114,35%,5,4,1
168,49,69,44,-20,67%,115,27%,3,10,-7
168,24,32,5,-8,59%,113,34%,2,5,-3
168,15,12,5,3,76%,96,26%,2,0,2
169,41,46,14,-5,74%,110,37%,6,7,-1
169,41,45,28,-4,73%,110,25%,6,7,-1
169,22,34,5,-12,56%,122,18%,3,5,-2
169,16,15,3,1,69%,124,24%,1,1,0
169,26,33,9,-7,69%,125,26%,3,3,0
169,23,37,11,-14,67%,99,24%,7,6,1
169,19,30,16,-11,74%,100,20%,3,5,-2
169,37,46,30,-9,74%,113,21%,5,4,1
169,21,27,5,-6,58%,117,29%,3,3,0
169,25,33,4,-8,56%,116,19%,7,8,-1
169,56,70,11,-14,60%,107,20%,12,15,-3
169,31,49,22,-18,62%,109,23%,7,4,3
169,25,34,10,-9,56%,106,28%,3,1,2
169,27,37,9,-10,47%,110,25%,5,9,-4
169,19,26,11,-7,69%,122,10%,2,3,-1
169,37,43,16,-6,75%,126,20%,1,2,-1
169,31,46,19,-15,65%,109,24%,6,10,-4
170,24,30,14,-6,61%,114,29%,3,4,-1
170,38,46,18,-8,64%,117,29%,3,6,-3
170,73,81,34,-8,75%,112,23%,6,8,-2
170,20,23,7,-3,72%,120,21%,2,4,-2
170,37,45,19,-8,68%,114,35%,4,3,1
170,27,36,12,-9,72%,102,17%,6,7,-1
170,17,14,4,3,67%,104,63%,0,2,-2
170,43,50,24,-7,74%,109,24%,4,7,-3
170,22,14,7,8,78%,107,28%,2,2,0
170,41,46,22,-5,69%,112,15%,4,4,0
170,25,30,10,-5,68%,110,19%,1,2,-1
170,39,38,17,1,69%,105,23%,2,5,-3
170,37,46,10,-9,62%,122,26%,0,8,-8
171,22,26,14,-4,78%,102,26%,3,0,3
171,22,35,7,-13,55%,116,26%,0,1,-1
171,32,37,14,-5,71%,123,27%,4,5,-1
171,39,50,20,-11,71%,112,35%,4,4,0
171,22,22,17,0,74%,114,33%,2,0,2
171,22,26,14,-4,78%,102,26%,3,0,3
171,62,74,50,-12,71%,120,13%,8,7,1
171,44,48,23,-4,72%,111,28%,4,6,-2
171,15,15,2,0,67%,116,26%,1,4,-3
171,22,27,18,-5,80%,132,24%,2,2,0
171,26,29,15,-3,64%,123,30%,2,3,-1
171,24,22,16,2,76%,113,41%,3,5,-2
171,27,25,12,2,78%,116,46%,1,1,0
171,24,33,15,-9,73%,100,21%,1,2,-1
171,28,31,13,-3,70%,115,22%,6,3,3
171,35,39,18,-4,72%,129,42%,1,7,-6
171,26,32,12,-6,67%,112,41%,1,4,-3
172,21,32,8,-11,68%,128,20%,4,8,-4
172,22,24,14,-2,68%,117,22%,3,5,-2
172,38,47,22,-9,65%,104,18%,4,10,-6
172,22,33,7,-11,60%,119,24%,2,4,-2
172,21,32,8,-11,68%,128,20%,4,8,-4
172,22,24,31,-2,84%,112,23%,3,2,1
172,25,27,12,-2,76%,108,17%,2,6,-4
172,13,14,2,-1,68%,112,32%,0,2,-2
172,21,32,12,-11,72%,115,21%,2,5,-3
172,49,54,11,-5,73%,122,29%,2,3,-1
172,33,35,15,-2,71%,103,17%,5,3,2
172,44,45,29,-1,67%,120,32%,4,5,-1
172,18,31,8,-13,54%,111,43%,3,3,0
172,24,34,16,-10,74%,110,30%,2,0,2
172,26,24,17,2,80%,115,16%,0,3,-3
172,35,40,12,-5,70%,118,23%,8,4,4
172,23,24,17,-1,79%,129,19%,2,4,-2
173,26,36,6,-10,60%,118,42%,7,9,-2
173,35,47,23,-12,69%,107,29%,4,5,-1
173,25,26,18,-1,75%,110,21%,2,1,1
173,26,28,11,-2,74%,127,25%,4,5,-1
173,26,30,10,-4,61%,110,19%,6,4,2
173,32,36,8,-4,67%,109,36%,3,7,-4
173,41,52,20,-11,61%,113,19%,6,5,1
173,21,30,15,-9,74%,118,22%,3,4,-1
173,23,30,7,-7,70%,106,38%,4,5,-1
173,24,22,18,2,72%,119,18%,4,7,-3
173,49,50,16,-1,69%,122,28%,6,11,-5
173,25,29,18,-4,79%,107,19%,2,6,-4
173,20,30,12,-10,56%,129,18%,1,1,0
173,27,37,7,-10,58%,104,26%,4,7,-3
173,25,32,7,-7,63%,123,34%,6,8,-2
173,37,60,13,-23,57%,112,22%,7,16,-9
173,37,44,17,-7,70%,110,24%,1,4,-3
174,46,47,17,-1,72%,124,17%,3,5,-2
174,28,31,11,-3,77%,113,24%,3,4,-1
174,41,43,20,-2,68%,107,24%,3,6,-3
174,32,38,12,-6,69%,111,17%,6,4,2
174,19,25,37,-6,79%,111,15%,2,2,0
174,13,18,8,-5,71%,108,23%,0,1,-1
174,40,59,16,-19,60%,118,20%,4,9,-5
174,29,24,11,5,73%,112,23%,5,4,1
174,35,32,20,3,75%,119,12%,3,3,0
174,25,33,14,-8,74%,120,19%,3,3,0
174,28,31,10,-3,69%,114,14%,2,3,-1
174,20,21,7,-1,69%,102,11%,5,5,0
174,12,16,1,-4,61%,110,23%,1,0,1
174,42,47,15,-5,67%,123,24%,3,5,-2
174,39,49,17,-10,64%,111,30%,3,3,0
174,41,50,31,-9,67%,102,27%,7,6,1
174,38,46,27,-8,72%,121,24%,0,2,-2
174,40,40,12,0,75%,128,23%,3,7,-4
174,39,51,14,-12,67%,120,25%,4,2,2
175,22,30,4,-8,63%,128,20%,5,4,1
175,47,46,30,1,72%,119,32%,4,7,-3
175,28,27,18,1,73%,119,33%,2,5,-3
175,26,31,3,-5,58%,129,27%,5,8,-3
175,21,36,10,-15,55%,120,31%,5,9,-4
175,34,46,14,-12,67%,112,28%,4,7,-3
175,36,41,29,-5,85%,123,19%,2,2,0
175,28,20,20,8,71%,115,25%,2,4,-2
175,27,30,5,-3,53%,119,24%,1,4,-3
175,17,16,6,1,69%,106,33%,1,3,-2
175,39,45,22,-6,73%,125,25%,4,2,2
175,24,29,8,-5,51%,110,23%,4,6,-2
175,25,36,9,-11,69%,132,23%,9,10,-1
175,22,33,7,-11,56%,118,26%,4,6,-2
175,27,30,18,-3,73%,115,21%,1,5,-4
175,30,45,14,-15,55%,121,27%,4,10,-6
175,24,31,12,-7,72%,134,19%,2,1,1
175,22,34,5,-12,49%,118,27%,3,7,-4
175,20,27,13,-7,64%,126,17%,0,3,-3
175,36,46,8,-10,58%,118,23%,4,5,-1
175,41,47,10,-6,67%,123,31%,2,4,-2
176,23,31,7,-8,48%,107,23%,4,4,0
176,38,45,16,-7,75%,119,29%,6,6,0
176,34,43,18,-9,70%,114,13%,2,5,-3
176,28,30,5,-2,73%,115,18%,6,4,2
176,22,32,13,-10,63%,125,21%,2,7,-5
176,26,22,8,4,89%,126,37%,2,6,-4
176,23,31,4,-8,50%,113,23%,6,6,0
176,43,52,29,-9,72%,116,16%,4,5,-1
176,24,21,9,3,79%,119,17%,0,2,-2
176,21,22,12,-1,76%,121,22%,5,3,2
176,29,31,5,-2,81%,99,24%,2,3,-1
176,28,20,8,8,74%,121,29%,1,4,-3
176,23,31,5,-8,56%,115,38%,4,3,1
176,24,33,7,-9,64%,118,22%,4,3,1
176,29,34,16,-5,71%,115,25%,7,6,1
176,43,45,26,-2,69%,107,25%,4,3,1
176,76,72,17,4,73%,123,27%,6,5,1
176,24,37,12,-13,63%,116,25%,0,5,-5
177,27,25,19,2,75%,122,24%,4,1,3
177,38,41,21,-3,69%,124,29%,5,6,-1
177,28,14,14,14,83%,119,15%,3,2,1
177,15,22,9,-7,71%,105,14%,3,7,-4
177,24,39,8,-15,56%,123,24%,9,11,-2
177,23,20,13,3,85%,107,16%,2,0,2
177,23,32,13,-9,61%,115,30%,5,4,1
177,42,45,29,-3,64%,121,20%,2,5,-3
177,31,44,7,-13,54%,119,17%,0,4,-4
177,41,44,16,-3,74%,116,25%,3,5,-2
177,27,21,3,6,64%,116,23%,1,2,-1
177,15,19,6,-4,67%,123,35%,0,1,-1
177,26,33,14,-7,79%,129,26%,0,1,-1
178,37,42,12,-5,67%,124,22%,7,12,-5
178,28,36,23,-8,67%,117,22%,4,2,2
178,35,41,17,-6,69%,123,21%,0,8,-8
178,35,42,18,-7,62%,125,24%,5,2,3
178,45,43,19,2,73%,125,23%,1,4,-3
178,42,53,29,-11,70%,122,19%,4,10,-6
178,44,52,21,-8,69%,108,16%,9,8,1
178,20,30,8,-10,49%,123,29%,3,3,0
178,35,35,28,0,78%,115,25%,2,4,-2
178,28,27,6,1,76%,116,35%,1,1,0
178,40,47,19,-7,66%,130,31%,3,5,-2
178,20,30,13,-10,64%,115,27%,0,2,-2
178,41,45,10,-4,63%,122,39%,4,5,-1
178,24,31,0,-7,53%,110,22%,5,4,1
178,28,28,10,0,74%,112,32%,5,3,2
179,26,28,19,-2,66%,124,13%,1,3,-2
179,26,28,19,-2,66%,124,13%,1,3,-2
179,31,47,23,-16,62%,119,24%,6,6,0
179,25,30,10,-5,68%,121,15%,2,2,0
179,26,25,7,1,66%,109,21%,5,5,0
179,42,48,7,-6,62%,109,27%,5,9,-4
179,24,29,7,-5,61%,113,21%,3,4,-1
179,23,34,11,-11,65%,118,21%,5,3,2
179,17,28,3,-11,39%,122,16%,0,5,-5
179,26,32,21,-6,69%,132,38%,1,6,-5
179,28,25,14,3,77%,115,25%,3,3,0
179,24,30,10,-6,63%,125,17%,4,2,2
179,8,12,4,-4,73%,116,23%,2,3,-1
179,23,28,8,-5,59%,121,24%,6,4,2
179,51,47,33,4,79%,117,26%,5,8,-3
179,63,73,24,-10,66%,117,31%,5,10,-5
179,50,59,8,-9,60%,112,22%,7,9,-2
179,27,37,12,-10,70%,125,21%,7,4,3
179,25,37,16,-12,72%,113,23%,0,3,-3
180,29,25,10,4,74%,121,35%,3,2,1
180,30,34,16,-4,69%,118,22%,5,6,-1
180,28,33,13,-5,59%,106,19%,3,5,-2
180,19,31,6,-12,50%,120,15%,4,5,-1
180,46,59,21,-13,70%,129,22%,8,7,1
180,26,29,8,-3,73%,120,27%,4,8,-4
180,13,13,9,0,70%,98,28%,3,1,2
180,35,49,4,-14,46%,115,31%,9,15,-6
180,27,32,5,-5,65%,122,36%,5,2,3
180,23,32,16,-9,69%,125,28%,2,2,0
180,38,52,18,-14,58%,118,18%,5,12,-7
180,26,22,13,4,76%,110,25%,2,3,-1
181,44,47,31,-3,75%,121,15%,6,7,-1
181,24,30,11,-6,63%,120,25%,2,5,-3
181,42,52,17,-10,66%,119,22%,5,6,-1
181,13,15,0,-2,62%,133,43%,4,2,2
181,15,13,3,2,71%,123,38%,2,1,1
181,35,38,14,-3,62%,128,22%,1,2,-1
181,25,28,10,-3,53%,124,27%,1,1,0
181,44,50,16,-6,63%,122,26%,6,7,-1
181,47,53,8,-6,65%,120,35%,11,4,7
181,25,27,10,-2,71%,118,21%,1,3,-2
181,42,43,12,-1,77%,132,21%,7,6,1
181,41,41,32,0,74%,114,21%,2,5,-3
181,11,18,9,-7,59%,122,35%,1,3,-2
181,18,19,4,-1,60%,136,15%,3,5,-
181,27,33,7,-6,76%,119,25%,5,5,0
181,49,53,20,-4,66%,121,29%,3,7,-4
181,50,67,25,-17,66%,121,27%,8,9,-1
181,50,44,28,6,78%,117,28%,1,0,1
181,41,34,20,7,78%,119,25%,2,1,1
181,40,36,15,4,75%,129,24%,4,3,1
181,30,30,12,0,79%,111,23%,3,2,1
181,25,23,11,2,79%,116,29%,4,3,1
181,32,27,20,5,88%,130,28%,2,3,-1
181,15,19,3,-4,75%,124,21%,6,6,0
181,31,30,5,1,66%,124,36%,1,3,-2
182,24,24,24,0,75%,117,26%,4,5,-1
182,29,34,6,-5,60%,123,25%,3,2,1
182,26,32,10,-6,72%,133,30%,2,3,-1
182,43,41,26,2,75%,122,20%,6,0,6
182,22,33,5,-11,53%,118,22%,5,7,-2
182,31,25,11,6,76%,113,16%,1,2,-1
182,26,30,19,-4,80%,125,25%,4,7,-3
182,14,16,8,-2,73%,139,22%,0,1,-1
182,26,25,4,1,69%,134,24%,5,5,0
182,13,11,5,2,70%,122,18%,4,4,0
182,40,37,25,3,73%,113,33%,6,6,0
182,21,28,3,-7,69%,118,37%,1,2,-1
182,26,33,6,-7,56%,118,19%,4,9,-5
182,39,48,19,-9,70%,132,28%,5,9,-4
183,45,38,17,7,73%,130,46%,5,5,0
183,13,11,11,2,71%,139,33%,2,1,1
183,31,31,11,0,70%,118,24%,0,2,-2
183,34,39,16,-5,83%,132,24%,5,5,0
183,21,30,4,-9,56%,128,34%,1,8,-7
183,25,22,14,3,72%,118,13%,3,1,2
183,27,34,6,-7,65%,120,34%,5,8,-3
183,46,51,25,-5,73%,124,33%,8,7,1
183,29,29,14,0,74%,126,20%,2,8,-6
183,25,22,10,3,83%,130,24%,2,2,0
183,26,36,7,-10,56%,121,10%,6,9,-3
183,47,51,19,-4,74%,124,27%,3,8,-5
183,42,51,29,-9,66%,125,26%,3,8,-5
183,41,46,11,-5,79%,129,28%,1,4,-3
183,60,68,18,-8,72%,125,21%,6,10,-4
183,39,54,16,-15,62%,120,27%,3,7,-4
183,28,30,18,-2,67%,130,35%,0,3,-3
183,18,28,4,-10,53%,116,38%,3,4,-1
183,41,53,17,-12,58%,126,25%,2,8,-6
183,28,29,6,-1,55%,110,17%,0,3,-3
183,24,34,6,-10,59%,111,23%,2,9,-7
184,25,21,15,4,79%,121,32%,1,3,-2
184,29,39,21,-10,69%,125,21%,5,8,-3
184,77,72,43,5,72%,117,17%,4,11,-7
184,46,44,17,2,74%,126,29%,3,5,-2
184,39,51,24,-12,60%,117,16%,8,11,-3
184,33,36,14,-3,65%,134,23%,3,13,-10
184,12,6,7,6,87%,106,25%,2,1,1
184,42,44,22,-2,77%,126,20%,3,0,3
184,41,50,39,-9,70%,123,21%,4,4,0
184,31,31,10,0,69%,107,22%,1,4,-3
184,62,70,8,-8,62%,123,38%,12,16,-4
184,29,33,7,-4,63%,120,25%,3,0,3
184,28,34,10,-6,69%,132,29%,4,5,-1
184,41,38,12,3,78%,123,28%,4,3,1
185,36,38,17,-2,67%,117,22%,5,8,-3
185,40,43,13,-3,70%,129,38%,2,9,-7
185,30,30,6,0,64%,135,25%,1,6,-5
185,14,13,4,1,76%,125,24%,0,0,0
185,13,17,2,-4,52%,122,22%,4,4,0
185,15,19,8,-4,73%,129,28%,2,1,1
185,40,50,10,-10,70%,126,28%,9,12,-3
185,23,22,13,1,80%,122,31%,2,1,1
185,29,34,15,-5,67%,120,30%,6,6,0
185,44,57,15,-13,69%,113,13%,2,6,-4
185,24,21,19,3,92%,118,19%,2,1,1
185,14,15,11,-1,95%,130,26%,3,2,1
185,17,19,6,-2,54%,115,19%,3,3,0
185,23,36,16,-13,72%,110,23%,3,5,-2
186,22,31,11,-9,62%,127,20%,4,6,-2
186,22,29,3,-7,47%,120,28%,3,6,-3
186,42,41,18,1,67%,135,29%,2,9,-7
186,31,27,12,4,75%,107,15%,3,1,2
186,47,48,26,-1,69%,115,21%,6,3,3
186,14,14,7,0,75%,141,17%,2,1,1
186,28,31,15,-3,65%,113,23%,6,8,-2
186,45,52,12,-7,69%,136,26%,4,1,3
186,25,32,9,-7,76%,127,21%,4,9,-5
186,58,53,20,5,66%,130,29%,12,6,6
186,25,30,9,-5,66%,134,25%,2,2,0
186,26,26,13,0,73%,120,30%,3,2,1
186,24,34,5,-10,59%,118,34%,5,6,-1
186,44,64,25,-20,68%,122,28%,10,7,3
186,62,62,28,0,73%,127,19%,3,8,-5
186,30,39,12,-9,71%,128,25%,7,4,3
187,26,24,25,2,79%,125,21%,0,0,0
187,24,30,15,-6,67%,130,21%,3,5,-2
187,69,74,39,-5,77%,119,15%,7,6,1
187,41,39,22,2,85%,120,29%,4,5,-1
187,72,77,30,-5,71%,123,19%,9,12,-3
187,41,50,27,-9,67%,127,21%,6,6,0
187,48,51,21,-3,65%,106,15%,6,8,-2
187,25,30,15,-5,68%,126,28%,3,4,-1
188,49,53,10,-4,71%,124,22%,17,10,7
188,20,28,13,-8,67%,132,28%,1,1,0
188,45,51,19,-6,66%,128,31%,5,10,-5
188,39,37,12,2,71%,125,30%,3,4,-1
188,25,27,13,-2,71%,129,17%,1,2,-1
188,14,15,4,-1,76%,127,32%,3,2,1
188,33,33,9,0,65%,132,45%,1,1,0
188,24,29,6,-5,61%,125,24%,4,5,-1
188,24,36,4,-12,55%,127,36%,6,7,-1
188,40,50,13,-10,62%,127,23%,6,13,-7
188,24,16,16,8,77%,123,28%,3,3,0
188,29,27,4,2,68%,114,29%,6,3,3
188,45,46,9,-1,68%,120,28%,6,2,4
188,35,37,5,-2,63%,117,20%,8,11,-3
188,61,67,13,-6,64%,125,27%,16,11,5
188,24,31,6,-7,56%,119,30%,2,2,0
188,27,33,6,-6,54%,117,24%,3,7,-4
189,25,29,10,-4,58%,128,17%,3,2,1
189,39,52,6,-13,55%,124,43%,4,15,-11
189,42,48,24,-6,70%,129,31%,3,2,1
189,29,22,11,7,79%,128,17%,2,4,-2
189,28,39,9,-11,64%,134,26%,1,3,-2
189,14,14,7,0,64%,142,21%,1,1,0
189,33,35,4,-2,63%,127,24%,5,2,3
189,44,50,38,-6,75%,122,14%,6,7,-1
189,29,26,14,3,72%,120,21%,3,5,-2
189,53,50,14,3,71%,131,28%,4,3,1
189,27,34,16,-7,70%,135,31%,2,3,-1
189,41,46,21,-5,70%,138,38%,2,7,-5
189,42,44,18,-2,78%,115,23%,6,8,-2
189,49,49,17,0,70%,122,19%,5,8,-3
189,33,45,11,-12,67%,115,25%,4,3,1
189,26,29,7,-3,61%,133,21%,4,5,-1
190,32,38,12,-6,81%,122,21%,7,6,1
190,46,40,17,6,72%,127,28%,2,5,-3
190,74,90,21,-16,62%,129,20%,17,26,-9
190,44,39,11,5,77%,128,32%,2,3,-1
190,22,32,9,-10,67%,133,23%,2,3,-1
190,24,30,7,-6,64%,128,33%,3,3,0
190,15,19,4,-4,75%,122,17%,2,4,-2
190,41,38,27,3,77%,130,12%,6,5,1
190,25,37,6,-12,66%,118,23%,3,2,1
190,46,47,24,-1,76%,130,20%,1,6,-5
190,21,22,8,-1,83%,107,29%,4,3,1
190,25,33,14,-8,67%,121,24%,2,4,-2
190,21,25,3,-4,53%,120,27%,1,1,0
190,40,34,10,6,69%,126,28%,5,5,0
190,49,53,16,-4,67%,123,31%,4,7,-3
190,29,25,10,4,68%,127,35%,3,5,-2
190,39,43,26,-4,76%,134,20%,4,6,-2
190,41,40,25,1,79%,131,19%,2,5,-3
190,34,33,8,1,73%,117,24%,2,3,-1
191,26,18,16,8,84%,120,11%,2,4,-2
191,27,27,9,0,73%,141,35%,3,3,0
191,40,41,22,-1,69%,118,11%,3,2,1
191,15,15,1,0,55%,119,48%,1,3,-2
191,31,28,11,3,71%,123,33%,1,6,-5
191,25,31,11,-6,61%,128,23%,5,3,2
191,25,23,17,2,77%,125,23%,3,1,2
191,44,44,13,0,62%,123,34%,6,5,1
191,45,51,21,-6,68%,130,29%,6,9,-3
191,42,53,23,-11,64%,138,34%,4,3,1
191,46,49,14,-3,58%,123,20%,5,16,-11
191,32,28,10,4,74%,110,22%,1,3,-2
191,27,34,2,-7,53%,133,23%,3,6,-3
191,26,30,6,-4,69%,131,43%,4,8,-4
191,23,32,7,-9,50%,126,27%,2,7,-5
191,44,33,18,11,75%,127,33%,1,5,-4
192,28,27,19,1,78%,121,43%,4,3,1
192,40,35,23,5,77%,130,21%,5,5,0
192,41,48,13,-7,66%,129,37%,7,9,-2
192,42,50,19,-8,61%,132,25%,6,5,1
192,28,21,14,7,82%,132,27%,2,2,0
192,40,42,28,-2,74%,123,14%,3,9,-6
192,26,21,13,5,84%,128,16%,1,1,0
192,39,46,16,-7,68%,128,32%,5,2,3
192,24,21,17,3,74%,135,34%,4,3,1
192,20,23,3,-3,70%,122,31%,3,5,-2
192,12,15,9,-3,70%,118,17%,3,1,2
192,25,20,9,5,75%,125,23%,6,3,3
192,50,62,22,-12,64%,125,34%,9,12,-3
192,40,35,11,5,75%,128,31%,8,8,0
192,28,36,12,-8,72%,131,44%,1,4,-3
192,30,23,19,7,79%,120,25%,4,3,1
192,16,28,5,-12,55%,130,26%,4,7,-3
192,28,36,13,-8,63%,129,18%,2,5,-3
193,41,42,15,-1,73%,132,23%,3,7,-4
193,22,32,13,-10,66%,134,14%,2,6,-4
193,31,34,11,-3,61%,147,25%,6,9,-3
193,28,31,10,-3,79%,141,24%,7,8,-1
193,31,36,16,-5,73%,127,32%,5,3,2
193,50,55,15,-5,67%,122,20%,11,4,7
193,32,32,9,0,64%,120,15%,3,4,-1
193,34,38,21,-4,71%,129,23%,6,4,2
193,31,21,6,10,71%,121,24%,3,2,1
193,32,28,3,4,63%,133,29%,1,7,-6
193,30,29,13,1,77%,140,33%,1,2,-1
193,74,74,31,0,71%,125,25%,9,5,4
193,37,41,11,-4,63%,128,30%,8,1,7
194,27,33,14,-6,68%,122,46%,4,6,-2
194,28,38,9,-10,61%,129,30%,5,4,1
194,40,48,13,-8,65%,123,23%,5,4,1
194,27,33,14,-6,68%,122,46%,4,6,-2
194,36,44,17,-8,76%,126,20%,6,6,0
194,43,39,25,4,68%,119,19%,4,3,1
194,30,26,10,4,74%,131,33%,2,4,-2
194,29,22,11,7,81%,113,24%,1,2,-1
194,26,18,5,8,81%,119,44%,3,2,1
194,24,33,11,-9,73%,137,27%,4,5,-1
194,38,50,7,-12,62%,125,20%,6,11,-5
194,31,38,10,-7,65%,143,25%,2,7,-5
194,24,27,8,-3,66%,129,38%,1,1,0
194,46,48,17,-2,71%,130,34%,5,11,-6
194,25,29,10,-4,59%,128,29%,3,6,-3
194,25,33,6,-8,64%,121,21%,4,2,2
194,21,21,29,0,77%,135,24%,3,3,0
194,49,51,18,-2,69%,140,21%,13,5,8
194,48,34,12,14,76%,134,36%,2,4,-2
194,28,25,17,3,83%,150,27%,0,5,-5
194,24,23,15,1,77%,125,23%,5,1,4
194,37,36,24,1,83%,149,20%,3,2,1
194,28,23,10,5,76%,129,31%,1,3,-2
195,28,29,11,-1,70%,136,27%,4,1,3
195,24,30,7,-6,57%,119,42%,6,3,3
195,16,12,12,4,77%,133,19%,2,1,1
195,27,32,6,-5,63%,129,16%,6,4,2
195,25,34,3,-9,56%,126,26%,5,3,2
195,16,15,5,1,81%,123,32%,0,1,-1
195,32,36,5,-4,56%,137,32%,6,7,-1
195,50,44,15,6,76%,131,22%,7,2,5
195,33,25,21,8,89%,131,32%,4,2,2
195,26,23,12,3,87%,116,11%,5,1,4
195,33,36,5,-3,72%,133,31%,2,6,-4
195,46,43,20,3,72%,124,29%,6,6,0
196,30,25,7,5,86%,136,28%,7,3,4
196,27,34,10,-7,61%,130,29%,3,5,-2
196,43,43,12,0,71%,123,28%,6,8,-2
196,51,48,7,3,64%,144,34%,0,9,-9
196,47,51,13,-4,69%,124,16%,10,10,0
196,47,45,22,2,70%,124,28%,3,4,-1
196,26,19,11,7,78%,112,20%,6,6,0
196,21,16,4,5,75%,131,40%,0,0,0
196,30,23,15,7,83%,120,22%,3,1,2
196,33,37,11,-4,65%,136,31%,1,4,-3
196,23,20,7,3,70%,125,28%,3,3,0
196,34,33,17,1,75%,119,22%,2,4,-2
196,37,35,9,2,73%,124,22%,2,7,-5
196,48,46,10,2,70%,129,19%,1,6,-5
196,26,21,15,5,70%,134,34%,2,8,-6
196,49,52,26,-3,74%,125,13%,4,5,-1
196,46,44,19,2,77%,133,17%,4,8,-4
196,30,31,6,-1,62%,128,14%,5,6,-1
196,31,29,9,2,80%,131,25%,5,3,2
196,26,31,14,-5,74%,137,13%,3,2,1
196,44,40,22,4,77%,140,45%,5,4,1
196,41,51,13,-10,68%,130,29%,11,10,1
196,44,51,11,-7,61%,135,32%,8,17,-9
196,24,28,24,-4,81%,142,19%,6,4,2
196,37,39,13,-2,74%,122,21%,4,2,2
196,39,42,15,-3,70%,133,30%,8,2,6
196,27,22,10,5,90%,129,20%,5,4,1
196,29,31,8,-2,59%,124,22%,3,4,-1
197,28,27,11,1,73%,135,30%,2,4,-2
197,35,41,15,-6,63%,119,30%,7,4,3
197,36,42,6,-6,63%,122,23%,10,11,-1
197,43,49,15,-6,69%,140,28%,7,13,-6
197,19,15,6,4,83%,120,29%,2,0,2
197,18,16,4,2,67%,118,27%,3,6,-3
197,31,28,16,3,85%,145,43%,0,2,-2
197,46,49,22,-3,73%,130,25%,6,8,-2
197,13,14,9,-1,67%,152,32%,1,3,-2
197,32,29,9,3,71%,128,33%,5,3,2
197,41,33,10,8,75%,130,20%,6,5,1
197,24,33,8,-9,67%,134,23%,7,6,1
197,76,64,34,12,80%,125,23%,4,8,-4
197,25,29,2,-4,50%,125,43%,8,7,1
198,29,23,10,6,73%,132,38%,4,4,0
198,27,34,10,-7,70%,126,17%,4,7,-3
198,34,34,6,0,69%,147,30%,2,4,-2
198,48,47,18,1,70%,120,25%,7,7,0
198,26,31,3,-5,67%,127,35%,5,4,1
198,48,42,21,6,78%,130,35%,2,1,1
198,46,48,17,-2,70%,143,33%,6,6,0
198,32,28,10,4,73%,135,27%,2,2,0
198,21,32,16,-11,66%,145,28%,2,2,0
198,30,35,6,-5,61%,136,30%,6,11,-5
198,43,52,17,-9,72%,129,20%,6,15,-9
198,14,15,5,-1,55%,138,27%,3,3,0
198,26,31,9,-5,66%,129,18%,8,8,0
199,27,35,14,-8,61%,149,27%,3,5,-2
199,25,34,9,-9,65%,133,22%,8,4,4
199,25,28,8,-3,58%,139,33%,3,4,-1
199,27,35,14,-8,61%,149,27%,3,5,-2
199,49,47,21,2,72%,135,37%,6,10,-4
199,48,47,15,1,75%,129,16%,10,2,8
199,32,30,11,2,71%,139,26%,3,7,-4
199,15,9,3,6,84%,151,33%,4,0,4
199,27,22,17,5,87%,131,18%,7,4,3
199,23,29,5,-6,62%,137,27%,2,2,0
199,17,12,5,5,86%,108,19%,2,0,2
199,32,29,13,3,64%,132,30%,2,3,-1
199,45,39,20,6,76%,123,28%,5,6,-1
199,38,29,16,9,77%,129,35%,9,5,4
199,29,24,10,5,76%,130,28%,3,0,3
199,50,45,29,5,76%,128,33%,2,6,-4
199,38,32,25,6,75%,132,33%,3,3,0
199,50,47,27,3,81%,132,30%,6,5,1
200,51,51,25,0,72%,145,22%,5,2,3
200,44,30,8,14,78%,127,27%,1,2,-1
200,42,43,13,-1,68%,125,27%,8,6,2
200,30,35,7,-5,61%,136,22%,3,11,-8
200,39,35,22,4,78%,140,34%,0,4,-4
200,30,34,14,-4,74%,130,33%,3,3,0
200,45,50,17,-5,73%,146,26%,12,11,1
200,35,42,15,-7,64%,137,17%,7,9,-2
200,47,47,11,0,76%,135,14%,7,5,2
200,48,46,15,2,76%,140,31%,5,5,0
200,38,29,24,9,69%,125,21%,0,5,-5
200,74,81,21,-7,71%,138,31%,17,25,-8
200,27,18,11,9,85%,124,26%,6,3,3
200,29,29,15,0,78%,128,29%,1,1,0
200,16,20,1,-4,50%,120,30%,4,5,-1
200,44,43,19,1,68%,128,28%,9,7,2
200,25,33,4,-8,58%,121,33%,7,6,1
201,24,21,15,3,81%,134,18%,1,2,-1
201,41,37,15,4,68%,131,17%,9,9,0
201,31,33,10,-2,73%,140,28%,2,2,0
201,40,39,19,1,74%,128,28%,4,7,-3
201,40,48,9,-8,62%,135,27%,5,6,-1
201,40,43,15,-3,67%,133,29%,8,10,-2
201,44,48,9,-4,65%,131,19%,4,11,-7
201,46,44,13,2,69%,129,23%,6,9,-3
201,27,30,9,-3,75%,132,31%,1,3,-2
201,51,49,8,2,67%,140,22%,3,11,-8
201,40,47,8,-7,59%,136,14%,6,6,0
201,29,24,13,5,73%,134,22%,4,1,3
201,51,50,26,1,66%,144,29%,5,2,3
201,16,15,11,1,83%,127,22%,1,1,0
201,53,48,16,5,70%,126,21%,6,5,1
201,57,51,19,6,79%,124,17%,4,9,-5
201,24,16,18,8,84%,144,30%,3,3,0
201,29,35,4,-6,66%,126,25%,10,10,0
201,47,41,19,6,70%,142,24%,3,0,3
201,45,55,18,-10,61%,141,19%,2,2,0
201,32,33,4,-1,67%,118,16%,6,5,1
201,29,22,10,7,80%,136,24%,3,2,1
202,30,25,9,5,65%,125,31%,4,0,4
202,29,25,14,4,70%,125,36%,0,6,-6
202,22,33,15,-11,68%,142,28%,2,2,0
202,25,32,8,-7,70%,135,27%,1,2,-1
202,29,36,19,-7,65%,136,31%,7,6,1
202,76,83,27,-7,76%,129,18%,16,6,10
202,43,38,17,5,74%,125,24%,4,8,-4
202,36,42,20,-6,63%,136,24%,4,3,1
202,39,36,14,3,73%,131,31%,2,2,0
202,31,30,14,1,71%,131,39%,2,4,-2
202,30,24,12,6,88%,137,29%,2,5,-3
202,21,27,2,-6,55%,127,29%,2,8,-6
202,20,16,8,4,73%,140,33%,2,4,-2
202,26,18,11,8,83%,140,31%,3,1,2
202,43,42,14,1,67%,127,33%,7,10,-3
202,17,11,6,6,65%,102,42%,4,1,3
202,15,17,4,-2,76%,123,14%,6,7,-1
202,52,47,19,5,71%,137,33%,5,5,0
202,49,51,22,-2,77%,134,23%,4,4,0
202,30,32,6,-2,60%,134,31%,8,6,2
202,52,44,21,8,69%,125,31%,4,6,-2
202,46,50,17,-4,74%,136,25%,8,9,-1
202,38,47,24,-9,73%,143,14%,6,3,3
202,42,45,23,-3,80%,134,19%,0,1,-1
202,44,50,18,-6,64%,134,26%,10,8,2
202,24,33,14,-9,67%,134,35%,1,3,-2
202,30,22,17,8,83%,123,22%,2,2,0
202,27,34,11,-7,65%,141,23%,4,4,0
203,39,45,24,-6,72%,127,25%,11,4,7
203,43,43,19,0,68%,126,36%,3,7,-4
203,51,45,14,6,67%,141,26%,5,9,-4
203,51,54,33,-3,74%,147,28%,7,8,-1
203,27,21,13,6,86%,133,24%,3,5,-2
203,30,32,10,-2,64%,143,27%,3,5,-2
203,20,30,10,-10,69%,135,25%,12,12,0
203,29,28,18,1,72%,130,31%,5,5,0
203,9,14,2,-5,73%,151,13%,2,1,1
203,55,59,30,-4,70%,143,21%,1,1,0
203,71,69,28,2,70%,143,33%,9,3,6
203,44,36,21,8,84%,132,23%,3,3,0
203,42,49,16,-7,70%,139,24%,10,9,1
203,40,40,18,0,67%,137,21%,7,6,1
203,34,34,5,0,64%,133,29%,5,8,-3
203,36,29,15,7,77%,130,31%,1,1,0
203,23,16,14,7,84%,141,23%,6,2,4
203,41,43,7,-2,57%,132,35%,6,12,-6
204,34,37,17,-3,73%,130,24%,3,3,0
204,32,30,9,2,75%,136,21%,3,8,-5
204,40,52,17,-12,67%,147,16%,10,9,1
204,18,13,4,5,65%,125,28%,3,0,3
204,30,29,4,1,61%,130,31%,3,6,-3
204,42,57,10,-15,54%,129,28%,10,13,-3
204,30,31,10,-1,67%,121,24%,2,2,0
204,27,32,2,-5,59%,145,30%,10,11,-1
204,46,48,17,-2,73%,137,17%,6,4,2
204,49,42,11,7,72%,146,26%,5,3,2
204,28,31,3,-3,62%,133,33%,9,6,3
204,45,46,3,-1,62%,125,29%,8,10,-2
204,41,48,17,-7,67%,138,19%,10,14,-4
204,29,34,20,-5,67%,142,34%,7,4,3
204,81,75,25,6,70%,140,30%,8,13,-5
204,35,39,10,-4,63%,136,28%,6,2,4
204,22,22,10,0,77%,124,18%,2,1,1
204,26,24,20,2,87%,127,12%,1,3,-2
205,27,32,8,-5,55%,140,20%,6,7,-1
205,32,21,15,11,81%,137,26%,3,7,-4
205,24,30,8,-6,72%,138,32%,2,8,-6
205,33,28,15,5,74%,138,24%,1,4,-3
205,18,12,4,6,61%,138,30%,0,2,-2
205,16,15,6,1,83%,152,32%,2,1,1
205,41,36,12,5,69%,139,39%,1,6,-5
205,52,46,31,6,76%,133,29%,9,8,1
205,53,47,14,6,69%,140,18%,11,8,3
205,35,42,8,-7,58%,133,18%,3,8,-5
205,42,44,10,-2,70%,129,14%,9,2,7
205,30,37,8,-7,67%,127,20%,9,6,3
205,33,30,8,3,67%,129,45%,5,4,1
205,30,35,6,-5,57%,126,19%,5,6,-1
205,15,8,4,7,76%,145,18%,1,1,0
205,43,53,20,-10,72%,140,28%,10,14,-4
206,24,34,15,-10,69%,138,21%,5,8,-3
206,46,49,17,-3,68%,139,24%,6,6,0
206,26,27,16,-1,76%,126,33%,1,2,-1
206,42,52,9,-10,63%,131,24%,14,12,2
206,34,29,12,5,76%,141,31%,2,5,-3
206,44,45,10,-1,72%,122,14%,7,3,4
206,29,33,18,-4,68%,124,25%,4,8,-4
206,33,23,9,10,74%,138,27%,4,3,1
206,27,32,8,-5,72%,129,26%,2,4,-2
206,37,36,18,1,65%,133,11%,2,2,0
206,28,31,15,-3,68%,140,25%,3,4,-1
206,51,45,22,6,73%,138,30%,6,7,-1
206,41,38,33,3,81%,135,18%,5,3,2
206,67,58,16,9,74%,129,28%,7,7,0
206,58,74,36,-16,66%,131,19%,10,11,-1
206,46,40,20,6,75%,127,27%,5,7,-2
206,24,32,5,-8,66%,135,18%,8,9,-1
206,37,34,20,3,68%,141,25%,2,6,-4
206,28,38,15,-10,67%,135,21%,6,3,3
206,36,29,11,7,83%,139,22%,5,1,4
206,47,36,27,11,78%,130,34%,1,4,-3
207,34,30,20,4,71%,143,23%,4,3,1
207,36,25,11,11,80%,140,29%,2,2,0
207,42,49,16,-7,80%,140,24%,5,6,-1
207,43,51,14,-8,67%,143,22%,10,5,5
207,26,16,15,10,86%,144,23%,3,0,3
207,55,48,18,7,75%,148,27%,4,0,4
207,30,26,5,4,66%,128,12%,8,8,0
207,52,48,24,4,66%,132,18%,10,1,9
207,33,30,24,3,74%,135,24%,1,4,-3
207,37,37,15,0,75%,132,21%,5,3,2
207,32,31,5,1,71%,132,18%,2,6,-4
207,28,23,7,5,77%,141,23%,6,3,3
207,46,56,20,-10,60%,135,21%,2,10,-8
207,43,47,14,-4,63%,132,22%,3,16,-13
207,29,20,9,9,85%,138,20%,7,0,7
208,30,18,13,12,79%,148,22%,1,0,1
208,32,26,7,6,75%,138,24%,5,1,4
208,32,26,7,6,75%,138,24%,5,1,4
208,83,81,25,2,72%,132,19%,18,8,10
208,37,39,12,-2,71%,132,22%,12,10,2
208,32,35,11,-3,73%,159,20%,5,8,-3
208,16,14,5,2,70%,139,22%,4,2,2
208,33,24,7,9,71%,143,36%,3,5,-2
208,48,52,13,-4,69%,132,25%,8,4,4
208,27,34,11,-7,72%,118,40%,5,3,2
208,40,36,10,4,65%,130,28%,5,5,0
208,31,28,19,3,78%,146,37%,4,2,2
208,49,47,17,2,75%,130,25%,8,6,2
208,44,49,15,-5,59%,136,23%,10,8,2
208,26,27,18,-1,87%,143,23%,7,1,6
208,19,15,5,4,67%,131,26%,1,0,1
208,15,17,10,-2,67%,138,19%,2,0,2
209,49,46,21,3,70%,139,34%,7,5,2
209,33,27,19,6,76%,142,32%,2,4,-2
209,31,21,8,10,76%,138,27%,5,0,5
209,44,48,10,-4,62%,135,26%,10,7,3
209,13,14,9,-1,76%,141,11%,2,3,-1
209,46,45,30,1,76%,135,25%,10,8,2
209,55,62,23,-7,68%,139,27%,6,4,2
209,51,49,25,2,80%,144,33%,4,4,0
209,11,12,4,-1,87%,138,16%,2,2,0
209,51,45,23,6,74%,135,28%,8,7,1
209,49,40,17,9,73%,130,24%,5,4,1
209,31,26,12,5,77%,135,27%,4,9,-5
209,54,48,39,6,79%,128,19%,4,7,-3
209,45,50,18,-5,74%,135,20%,4,8,-4
209,30,30,13,0,76%,140,20%,2,3,-1
209,46,52,21,-6,74%,138,17%,14,9,5
209,30,35,8,-5,64%,140,22%,3,9,-6
210,29,23,14,6,84%,119,29%,4,1,3
210,29,23,14,6,84%,119,29%,4,1,3
210,46,54,10,-8,61%,128,24%,12,11,1
210,44,43,14,1,71%,135,32%,5,1,4
210,26,32,7,-6,67%,133,18%,4,5,-1
210,29,30,23,-1,70%,145,21%,2,2,0
210,29,32,9,-3,67%,132,30%,7,6,1
210,54,50,21,4,73%,144,32%,9,6,3
210,27,25,16,2,83%,136,39%,5,2,3
210,23,20,9,3,70%,146,27%,4,3,1
210,56,53,20,3,73%,135,49%,7,2,5
210,58,45,33,13,78%,135,26%,9,10,-1
210,38,34,19,4,69%,139,27%,4,10,-6
210,31,17,12,14,81%,156,21%,4,4,0
210,22,33,11,-11,72%,147,17%,3,3,0
210,44,46,15,-2,74%,138,29%,2,6,-4
210,49,40,31,9,87%,144,23%,3,2,1
210,43,47,14,-4,70%,141,17%,11,7,4
210,28,30,13,-2,57%,150,33%,3,2,1
210,75,83,29,-8,69%,146,22%,6,11,-5
210,31,25,13,6,68%,142,33%,3,4,-1
211,24,29,15,-5,68%,149,26%,1,3,-2
211,38,36,20,2,84%,136,29%,6,5,1
211,46,47,19,-1,63%,138,25%,6,7,-1
211,34,35,8,-1,65%,138,27%,4,4,0
211,24,29,15,-5,68%,149,26%,1,3,-2
211,33,35,20,-2,76%,136,30%,2,3,-1
211,50,42,27,8,82%,141,16%,3,6,-3
211,21,14,18,7,84%,144,15%,5,2,3
211,31,29,11,2,70%,151,16%,3,2,1
211,35,20,11,15,79%,126,26%,3,4,-1
211,21,13,5,8,77%,145,15%,0,0,0
211,56,51,8,5,66%,148,39%,4,8,-4
211,51,44,20,7,74%,129,22%,6,4,2
211,31,33,13,-2,72%,146,36%,6,2,4
211,36,42,10,-6,65%,138,27%,4,7,-3
211,83,75,23,8,72%,128,25%,14,10,4
211,78,75,14,3,63%,134,25%,20,21,-1
211,45,45,14,0,78%,145,23%,7,9,-2
211,32,24,11,8,90%,130,18%,2,2,0
211,68,58,21,10,77%,144,26%,3,6,-3
211,50,36,20,14,78%,129,32%,10,2,8
211,43,46,7,-3,66%,127,18%,14,7,7
211,30,28,8,2,66%,140,31%,6,2,4
212,29,31,8,-2,70%,146,42%,3,3,0
212,53,40,16,13,75%,144,19%,2,3,-1
212,36,40,12,-4,62%,142,27%,4,9,-5
212,43,41,12,2,71%,145,25%,3,4,-1
212,31,28,15,3,67%,138,29%,5,3,2
212,61,52,16,9,81%,144,21%,8,5,3
212,25,35,12,-10,68%,147,27%,4,6,-2
212,21,23,4,-2,63%,136,30%,1,5,-4
212,30,20,13,10,71%,149,35%,2,3,-1
212,83,76,27,7,67%,140,31%,13,11,2
212,28,31,7,-3,58%,141,27%,5,4,1
212,41,43,12,-2,72%,141,39%,2,6,-4
213,18,18,9,0,77%,151,41%,1,2,-1
213,27,32,11,-5,68%,144,30%,4,5,-1
213,79,75,32,4,71%,129,23%,14,6,8
213,36,36,19,0,69%,154,33%,4,3,1
213,33,23,6,10,80%,144,29%,4,2,2
213,23,25,12,-2,77%,147,32%,2,3,-1
213,37,41,10,-4,66%,143,23%,5,8,-3
213,47,44,16,3,65%,138,35%,4,5,-1
213,45,47,24,-2,72%,140,14%,3,5,-2
213,31,33,15,-2,72%,145,26%,8,11,-3
214,53,54,8,-1,66%,133,22%,10,9,1
214,30,18,14,12,84%,149,20%,2,1,1
214,33,35,14,-2,70%,136,22%,8,3,5
214,52,47,30,5,75%,162,26%,3,2,1
214,18,10,7,8,77%,133,46%,0,0,0
214,41,50,12,-9,58%,144,15%,12,13,-1
214,33,30,7,3,71%,136,26%,3,4,-1
214,56,59,16,-3,63%,141,21%,16,17,-1
214,48,53,11,-5,64%,147,20%,10,17,-7
214,69,68,37,1,74%,138,19%,8,8,0
214,41,37,4,4,63%,149,21%,9,8,1
214,32,30,8,2,73%,133,14%,8,2,6
214,52,40,12,12,75%,146,28%,8,2,6
214,35,24,5,11,64%,139,25%,4,5,-1
215,57,47,16,10,69%,138,22%,6,3,3
215,31,37,11,-6,64%,143,21%,3,2,1
215,33,30,12,3,64%,136,37%,3,4,-1
215,48,43,7,5,68%,141,17%,3,4,-1
215,52,54,16,-2,76%,152,18%,11,11,0
215,30,29,10,1,74%,132,20%,7,6,1
215,32,36,18,-4,71%,142,22%,7,4,3
215,43,31,19,12,75%,139,29%,3,1,2
215,21,17,10,4,62%,153,55%,2,5,-3
215,18,20,4,-2,75%,139,19%,2,4,-2
215,32,27,10,5,71%,147,23%,6,5,1
215,61,62,13,-1,68%,142,24%,18,19,-1
215,54,45,13,9,68%,141,26%,6,7,-1
215,29,22,12,7,89%,142,22%,3,1,2
215,30,29,5,1,63%,134,31%,12,9,3
215,50,39,24,11,69%,128,29%,3,4,-1
215,53,42,18,11,70%,129,25%,7,7,0
215,27,20,11,7,77%,128,35%,3,1,2
215,31,26,6,5,74%,137,27%,5,6,-1
215,32,29,12,3,78%,129,31%,2,3,-1
216,56,54,12,2,63%,145,34%,12,11,1
216,32,29,19,3,77%,141,22%,4,3,1
216,32,29,19,3,77%,141,22%,4,3,1
216,43,52,15,-9,71%,147,33%,6,5,1
216,55,38,19,17,79%,141,25%,7,0,7
216,16,19,7,-3,67%,140,22%,3,1,2
216,49,51,24,-2,69%,149,34%,6,8,-2
216,84,70,29,14,67%,132,23%,8,7,1
216,53,44,17,9,71%,142,25%,8,5,3
216,35,29,18,6,75%,142,35%,2,4,-2
216,30,31,5,-1,62%,152,27%,4,6,-2
217,31,25,15,6,79%,145,34%,5,3,2
217,38,34,13,4,80%,154,22%,2,1,1
217,32,25,8,7,74%,131,27%,6,4,2
217,22,22,1,0,71%,140,30%,7,5,2
217,55,48,20,7,76%,151,33%,6,8,-2
217,16,13,3,3,81%,145,17%,6,2,4
217,30,25,8,5,87%,152,20%,11,4,7
217,49,44,14,5,68%,152,35%,3,5,-2
217,31,36,13,-5,60%,131,24%,1,4,-3
217,26,29,4,-3,56%,141,31%,7,10,-3
217,42,34,17,8,81%,132,34%,3,0,3
217,52,49,17,3,72%,138,25%,5,3,2
217,47,44,26,3,70%,155,34%,2,4,-2
217,14,11,8,3,85%,151,36%,3,3,0
218,27,29,14,-2,69%,137,29%,5,3,2
218,30,23,13,7,76%,147,35%,6,1,5
218,27,10,8,17,90%,148,33%,0,0,0
218,16,18,4,-2,79%,158,21%,2,3,-1
218,53,45,37,8,72%,156,22%,7,9,-2
218,47,39,15,8,72%,133,30%,8,5,3
218,46,36,18,10,75%,141,33%,7,3,4
218,31,27,20,4,77%,138,20%,2,3,-1
218,33,34,20,-1,73%,146,17%,4,1,3
218,34,37,16,-3,74%,147,16%,6,3,3
218,18,10,7,8,81%,162,32%,2,0,2
218,55,59,17,-4,75%,134,32%,9,6,3
218,29,21,8,8,81%,151,34%,4,3,1
218,28,18,10,10,81%,141,23%,5,0,5
218,30,24,13,6,67%,126,33%,2,4,-2
218,48,48,15,0,57%,141,32%,7,7,0
218,42,35,17,7,78%,125,26%,5,5,0
218,81,77,21,4,71%,144,30%,12,13,-1
219,32,29,2,3,65%,135,34%,6,5,1
219,35,32,7,3,68%,150,22%,4,2,2
219,43,46,17,-3,66%,139,28%,8,7,1
219,31,32,8,-1,68%,155,27%,1,3,-2
219,20,18,3,2,69%,143,33%,1,1,0
219,28,33,7,-5,65%,141,35%,3,4,-1
219,21,14,7,7,73%,143,31%,3,2,1
219,28,27,9,1,76%,138,30%,6,4,2
219,43,28,12,15,78%,144,14%,4,4,0
219,44,39,24,5,82%,142,22%,6,4,2
219,86,74,35,12,69%,142,27%,12,13,-1
219,33,37,7,-4,73%,139,28%,7,8,-1
220,29,33,7,-4,68%,142,35%,6,4,2
220,35,20,13,15,85%,150,22%,3,3,0
220,32,32,5,0,68%,142,27%,9,4,5
220,33,37,2,-4,55%,134,26%,7,9,-2
220,34,41,8,-7,67%,150,35%,11,7,4
220,36,30,16,6,75%,129,17%,4,2,2
220,33,32,9,1,67%,137,43%,5,3,2
220,21,24,11,-3,87%,144,41%,3,1,2
220,34,29,24,5,74%,134,44%,4,5,-1
220,45,51,11,-6,65%,141,17%,15,13,2
220,53,49,8,4,68%,142,30%,10,5,5
220,43,36,14,7,75%,146,40%,2,1,1
220,30,33,10,-3,73%,140,33%,6,3,3
220,28,32,6,-4,58%,149,23%,6,2,4
220,47,51,12,-4,64%,154,38%,9,5,4
220,48,51,18,-3,73%,148,30%,4,4,0
220,33,25,20,8,81%,152,25%,1,3,-2
221,37,34,11,3,67%,149,17%,8,8,0
221,46,55,10,-9,63%,147,23%,10,5,5
221,27,31,3,-4,61%,139,13%,7,8,-1
221,52,47,16,5,73%,155,19%,8,8,0
221,33,28,1,5,66%,141,48%,8,3,5
221,34,33,11,1,64%,137,19%,3,4,-1
221,35,25,5,10,79%,144,24%,8,5,3
221,34,23,9,11,77%,145,33%,4,2,2
221,27,34,10,-7,69%,151,15%,5,5,0
221,72,69,23,3,72%,148,30%,9,6,3
221,46,39,13,7,75%,150,21%,7,6,1
221,53,35,7,18,82%,149,29%,9,3,6
221,83,79,16,4,68%,139,22%,32,17,15
221,51,37,13,14,77%,152,31%,6,7,-1
222,33,23,10,10,84%,141,30%,5,0,5
222,56,51,7,5,67%,142,26%,13,10,3
222,15,15,5,0,65%,157,21%,2,3,-1
222,20,18,4,2,63%,132,22%,4,1,3
222,27,30,8,-3,68%,146,23%,2,3,-1
222,12,13,0,-1,69%,143,31%,0,1,-1
222,61,61,18,0,72%,154,48%,10,3,7
222,53,60,26,-7,71%,146,42%,9,8,1
222,58,40,19,18,74%,159,37%,3,5,-2
222,32,19,18,13,82%,139,23%,5,1,4
222,31,27,12,4,78%,141,19%,4,1,3
222,31,25,17,6,78%,145,27%,3,6,-3
222,53,48,5,5,58%,136,22%,11,8,3
223,50,54,12,-4,72%,152,27%,9,5,4
223,29,18,9,11,79%,145,32%,2,2,0
223,46,38,12,8,73%,136,19%,11,9,2
223,34,21,12,13,88%,152,29%,3,2,1
223,27,17,5,10,78%,144,19%,6,4,2
223,28,26,3,2,64%,146,41%,3,3,0
223,36,17,18,19,88%,144,26%,1,0,1
223,37,25,6,12,76%,148,20%,2,2,0
223,47,34,16,13,82%,133,29%,6,3,3
223,36,28,8,8,67%,141,35%,2,6,-4
223,38,32,5,6,58%,144,19%,13,12,1
223,19,14,9,5,67%,145,24%,2,1,1
223,30,12,14,18,87%,126,25%,3,2,1
223,32,32,8,0,73%,156,22%,7,4,3
224,29,28,11,1,73%,159,20%,2,2,0
224,50,46,16,4,73%,151,24%,10,5,5
224,58,59,12,-1,73%,128,24%,11,10,1
224,31,29,16,2,73%,138,22%,7,6,1
224,50,45,11,5,61%,160,36%,7,9,-2
224,35,24,10,11,84%,160,28%,2,3,-1
224,26,9,6,17,94%,143,18%,4,1,3
224,53,52,24,1,70%,147,26%,4,7,-3
224,32,26,16,6,80%,152,21%,4,6,-2
225,29,32,14,-3,78%,150,17%,4,5,-1
225,34,34,5,0,67%,139,37%,5,3,2
225,59,55,4,4,66%,146,38%,13,18,-5
225,33,22,13,11,72%,140,32%,4,2,2
225,49,39,15,10,78%,149,12%,4,2,2
225,28,33,9,-5,64%,148,23%,5,2,3
225,32,19,15,13,79%,150,26%,7,1,6
225,46,45,13,1,70%,156,30%,6,4,2
225,18,22,5,-4,62%,152,19%,4,4,0
225,56,50,14,6,69%,140,25%,7,9,-2
225,55,51,24,4,74%,141,17%,13,3,10
225,32,30,5,2,61%,143,23%,3,0,3
225,52,45,5,7,61%,148,48%,16,11,5
225,17,16,3,1,60%,134,21%,0,2,-2
226,17,13,2,4,71%,134,18%,4,5,-1
226,58,40,14,18,81%,141,27%,9,2,7
226,25,14,12,11,90%,136,19%,4,0,4
226,34,24,19,10,86%,142,26%,5,5,0
226,38,32,7,6,67%,152,24%,6,10,-4
226,64,55,15,9,68%,156,25%,9,7,2
226,53,49,20,4,73%,145,18%,7,6,1
226,48,40,15,8,75%,149,26%,6,2,4
227,36,27,5,9,70%,144,29%,9,6,3
227,51,53,11,-2,75%,150,39%,9,8,1
227,47,44,12,3,72%,158,34%,9,4,5
227,32,31,9,1,70%,159,26%,5,5,0
227,31,26,9,5,87%,151,27%,2,2,0
227,37,32,7,5,74%,147,36%,4,2,2
227,42,39,24,3,64%,150,35%,3,8,-5
227,18,13,8,5,71%,172,36%,1,1,0
227,35,27,3,8,63%,151,53%,4,5,-1
227,30,33,13,-3,72%,158,20%,6,5,1
227,36,34,7,2,71%,141,27%,8,11,-3
227,32,23,8,9,71%,152,21%,5,1,4
228,90,75,29,15,74%,140,20%,11,7,4
228,33,27,13,6,71%,162,21%,3,0,3
228,48,49,14,-1,73%,155,24%,11,4,7
228,33,21,12,12,79%,154,26%,3,1,2
228,26,32,3,-6,58%,169,21%,6,3,3
228,35,32,13,3,80%,145,28%,10,6,4
228,44,34,8,10,67%,144,23%,7,5,2
228,31,22,5,9,69%,145,26%,7,8,-1
228,62,39,25,23,85%,156,27%,6,2,4
228,52,44,12,8,69%,147,36%,2,7,-5
228,50,48,25,2,69%,141,21%,4,7,-3
228,52,56,6,-4,55%,159,38%,11,12,-1
229,37,29,10,8,80%,145,22%,5,6,-1
229,52,40,14,12,74%,150,31%,5,7,-2
229,48,39,8,9,66%,145,30%,9,9,0
229,31,21,10,10,83%,153,37%,4,1,3
229,31,31,5,0,63%,147,33%,3,2,1
229,45,41,18,4,73%,148,24%,10,9,1
229,35,33,7,2,67%,149,34%,5,4,1
229,34,35,10,-1,74%,159,24%,8,11,-3
230,31,22,8,9,74%,143,16%,4,4,0
230,37,33,5,4,61%,142,18%,9,9,0
230,32,20,16,12,80%,147,21%,4,4,0
230,55,37,10,18,71%,144,25%,10,7,3
230,51,44,14,7,73%,151,23%,14,5,9
230,36,37,12,-1,72%,162,31%,5,9,-4
230,16,21,11,-5,63%,159,16%,5,4,1
230,31,23,19,8,76%,155,15%,5,5,0
230,17,16,2,1,52%,148,27%,1,2,-1
230,38,28,10,10,84%,149,29%,5,1,4
230,34,26,10,8,77%,154,31%,7,9,-2
230,34,27,6,7,69%,134,23%,7,6,1
230,38,30,23,8,85%,152,23%,3,2,1
230,53,45,23,8,78%,159,30%,4,6,-2
230,37,29,4,8,77%,155,44%,8,4,4
231,51,48,13,3,68%,155,27%,14,5,9
231,46,50,20,-4,75%,142,16%,7,11,-4
231,31,26,12,5,79%,148,16%,11,7,4
231,48,37,17,11,72%,163,28%,2,3,-1
231,54,50,18,4,66%,146,35%,7,10,-3
231,34,31,9,3,77%,164,35%,4,2,2
231,23,20,4,3,70%,164,20%,6,4,2
231,37,28,7,9,71%,132,29%,3,2,1
231,39,44,14,-5,63%,160,27%,3,10,-7
232,42,36,8,6,79%,143,13%,7,7,0
232,50,47,16,3,68%,160,27%,9,14,-5
232,38,26,5,12,69%,146,23%,7,11,-4
232,58,52,20,6,65%,161,22%,4,8,-4
232,35,27,10,8,85%,142,28%,4,1,3
232,16,11,7,5,78%,158,35%,1,1,0
232,50,52,23,-2,65%,155,19%,8,7,1
232,38,32,17,6,78%,154,41%,4,5,-1
232,89,76,20,13,76%,153,16%,16,11,5
232,59,46,7,13,64%,152,34%,9,14,-5
232,37,27,5,10,73%,144,43%,1,2,-1
232,57,51,10,6,72%,154,22%,13,6,7
233,36,33,10,3,69%,154,11%,8,6,2
233,50,47,23,3,73%,163,28%,4,3,1
233,43,33,30,10,79%,150,30%,2,4,-2
233,29,28,5,1,64%,152,29%,4,4,0
233,44,35,17,9,69%,148,24%,3,5,-2
233,31,19,13,12,80%,153,39%,2,2,0
233,34,29,4,5,67%,160,30%,9,9,0
233,57,47,19,10,72%,156,24%,10,4,6
233,49,30,10,19,79%,144,28%,4,10,-6
233,38,33,15,5,71%,146,14%,5,5,0
233,53,45,15,8,70%,151,19%,10,10,0
234,36,22,11,14,77%,148,34%,3,0,3
234,37,25,11,12,77%,151,39%,5,4,1
234,17,17,4,0,62%,136,29%,5,4,1
234,31,21,12,10,83%,138,21%,9,3,6
234,30,33,10,-3,66%,143,15%,1,2,-1
234,30,16,12,14,83%,150,15%,4,0,4
234,25,22,5,3,81%,158,38%,9,4,5
234,33,28,17,5,71%,165,38%,0,5,-5
234,23,20,13,3,80%,172,27%,2,0,2
234,57,51,29,6,80%,150,23%,8,9,-1
234,62,48,22,14,79%,151,37%,6,8,-2
234,32,25,6,7,67%,142,19%,7,6,1
234,32,28,19,4,83%,141,37%,4,0,4
235,37,31,6,6,68%,150,40%,4,0,4
235,35,35,7,0,69%,149,22%,10,9,1
235,37,31,6,6,68%,150,40%,4,0,4
235,51,37,13,14,68%,142,24%,8,7,1
235,32,32,16,0,82%,167,20%,7,1,6
235,57,50,5,7,74%,163,41%,16,5,11
235,38,17,22,21,88%,147,44%,3,2,1
235,44,44,18,0,71%,162,17%,5,4,1
235,39,22,11,17,85%,142,29%,6,2,4
235,40,37,16,3,73%,145,25%,5,3,2
235,53,34,10,19,78%,164,25%,3,5,-2
235,57,49,27,8,77%,151,21%,3,6,-3
235,26,17,11,9,77%,143,31%,3,1,2
235,16,10,7,6,80%,152,30%,2,2,0
235,51,53,14,-2,64%,146,31%,11,12,-1
235,29,23,11,6,75%,145,24%,7,3,4
235,50,41,14,9,71%,149,26%,7,11,-4
235,35,18,2,17,69%,149,22%,4,3,1
235,22,27,6,-5,60%,152,27%,3,5,-2
235,50,40,17,10,82%,159,30%,10,3,7
235,35,25,7,10,80%,155,28%,1,5,-4
235,51,51,20,0,67%,163,38%,3,7,-4
235,52,35,16,17,83%,147,24%,3,8,-5
235,17,12,0,5,55%,149,47%,5,2,3
236,40,38,15,2,75%,162,17%,5,6,-1
236,32,19,14,13,89%,141,27%,3,1,2
236,39,33,18,6,80%,147,27%,2,5,-3
236,38,26,3,12,77%,154,23%,4,7,-3
236,28,24,11,4,74%,153,25%,7,3,4
236,32,22,4,10,74%,152,37%,4,1,3
236,58,50,10,8,70%,148,36%,15,9,6
236,86,71,27,15,73%,154,32%,11,5,6
236,35,33,7,2,71%,154,15%,8,3,5
237,32,24,13,8,75%,142,30%,6,2,4
237,55,41,24,14,75%,161,19%,4,4,0
237,35,17,5,18,86%,153,58%,3,2,1
237,17,16,4,1,71%,148,15%,5,0,5
237,34,24,8,10,89%,157,40%,4,2,2
237,27,22,12,5,91%,163,14%,9,6,3
237,61,49,19,12,71%,148,44%,5,6,-1
237,41,35,6,6,68%,154,31%,7,3,4
238,28,20,11,8,81%,158,23%,4,3,1
238,39,29,11,10,77%,153,21%,9,6,3
238,35,23,12,12,83%,149,16%,5,1,4
238,30,21,12,9,91%,152,33%,2,3,-1
238,22,20,5,2,81%,161,29%,4,1,3
238,17,18,3,-1,64%,161,27%,4,4,0
238,20,18,3,2,71%,148,32%,4,3,1
238,56,53,13,3,69%,157,32%,10,11,-1
238,32,22,13,10,76%,141,19%,6,5,1
238,35,19,4,16,76%,154,24%,4,3,1
238,45,36,12,9,81%,162,22%,4,1,3
238,53,40,17,13,83%,150,32%,8,5,3
239,54,45,19,9,71%,155,25%,6,8,-2
239,53,39,25,14,74%,157,27%,4,6,-2
239,36,32,4,4,79%,159,33%,7,3,4
239,52,38,16,14,81%,157,29%,5,5,0
239,53,44,12,9,76%,152,28%,11,5,6
239,33,34,9,-1,63%,155,29%,6,9,-3
239,31,20,6,11,74%,156,31%,3,2,1
239,21,19,2,2,75%,141,35%,5,3,2
239,64,40,22,24,76%,153,30%,10,7,3
239,38,29,11,9,79%,167,21%,5,10,-5
239,89,76,15,13,69%,164,31%,14,13,1
239,70,66,45,4,64%,154,21%,6,9,-3
239,61,52,4,9,71%,140,39%,16,9,7
239,53,44,16,9,66%,157,27%,7,4,3
239,38,25,16,13,77%,159,18%,5,0,5
239,33,31,6,2,61%,148,30%,10,6,4
240,37,37,5,0,59%,143,21%,10,8,2
240,59,51,13,8,74%,153,25%,11,13,-2
240,36,23,5,13,77%,144,27%,7,5,2
240,34,22,14,12,90%,159,12%,5,1,4
240,16,17,8,-1,77%,161,30%,7,1,6
240,12,5,8,7,93%,152,24%,1,0,1
240,74,59,33,15,77%,156,23%,12,8,4
240,33,20,10,13,84%,160,32%,2,1,1
240,40,22,5,18,77%,157,27%,2,3,-1
240,58,38,21,20,81%,164,17%,9,7,2
241,40,28,2,12,73%,144,26%,8,5,3
241,23,21,5,2,71%,155,26%,7,6,1
241,31,18,14,13,88%,152,22%,3,1,2
241,30,31,6,-1,70%,156,22%,6,2,4
241,30,29,15,1,72%,163,22%,3,4,-1
241,52,48,26,4,80%,162,14%,10,6,4
241,33,20,12,13,84%,169,27%,8,6,2
241,24,17,6,7,73%,169,23%,1,3,-2
242,34,31,13,3,68%,160,22%,4,7,-3
242,33,28,12,5,72%,156,27%,6,0,6
242,16,11,2,5,83%,149,34%,3,1,2
242,54,49,19,5,71%,160,18%,7,8,-1
242,38,34,3,4,64%,148,41%,7,4,3
242,40,28,10,12,76%,160,28%,3,2,1
242,76,64,24,12,74%,152,22%,12,4,8
242,51,47,10,4,75%,172,30%,8,3,5
242,48,35,27,13,79%,150,25%,8,8,0
242,22,19,2,3,63%,152,23%,4,7,-3
243,40,26,7,14,77%,153,27%,6,6,0
243,17,16,6,1,71%,167,38%,2,1,1
243,29,33,14,-4,71%,164,14%,3,6,-3
243,34,32,13,2,84%,160,24%,4,0,4
243,35,20,23,15,83%,160,45%,6,3,3
243,34,25,9,9,78%,151,21%,6,5,1
243,43,44,14,-1,65%,151,29%,7,7,0
243,34,33,10,1,74%,147,17%,10,9,1
243,31,31,4,0,64%,134,27%,6,3,3
243,80,72,16,8,72%,150,24%,18,14,4
243,37,41,17,-4,68%,164,27%,2,5,-3
244,35,21,8,14,72%,147,19%,8,4,4
244,35,26,5,9,75%,144,22%,7,2,5
244,33,31,6,2,75%,168,25%,6,4,2
244,58,44,16,14,71%,164,29%,7,7,0
244,19,14,4,5,71%,157,10%,5,0,5
244,46,39,13,7,69%,163,24%,6,1,5
244,36,34,7,2,64%,155,26%,9,6,3
244,24,18,12,6,90%,161,21%,7,4,3
244,37,22,13,15,86%,164,35%,4,0,4
245,29,31,7,-2,59%,156,25%,5,8,-3
245,29,31,7,-2,59%,156,25%,5,8,-3
245,34,27,9,7,77%,151,24%,6,5,1
245,35,34,9,1,73%,153,18%,12,6,6
245,51,44,23,7,75%,147,18%,7,5,2
245,24,13,9,11,79%,164,27%,2,0,2
245,42,36,13,6,65%,163,30%,4,5,-1
245,43,40,23,3,76%,157,30%,9,5,4
245,35,23,4,12,81%,148,32%,4,2,2
245,39,28,10,11,77%,168,39%,3,3,0
245,67,51,12,16,72%,153,26%,8,10,-2
245,59,51,17,8,70%,164,31%,10,3,7
245,25,24,7,1,80%,161,18%,5,5,0
246,28,25,14,3,77%,164,18%,11,5,6
246,19,17,4,2,73%,160,30%,4,1,3
246,38,29,17,9,71%,173,30%,4,2,2
246,17,9,11,8,89%,169,40%,2,0,2
246,32,23,21,9,82%,145,29%,4,5,-1
246,69,54,26,15,74%,158,26%,5,13,-8
246,33,22,8,11,83%,156,26%,3,3,0
246,45,36,10,9,75%,152,20%,6,7,-1
247,50,42,21,8,73%,168,20%,13,5,8
247,45,35,13,10,69%,168,30%,6,3,3
247,39,24,8,15,79%,167,26%,2,2,0
247,34,23,7,11,74%,146,30%,4,6,-2
247,49,37,7,12,75%,169,27%,13,6,7
247,58,54,18,4,69%,158,26%,13,15,-2
247,32,21,20,11,80%,136,20%,6,2,4
247,35,22,19,13,85%,147,28%,2,1,1
248,49,48,16,1,78%,171,21%,8,9,-1
248,30,33,11,-3,74%,173,38%,5,6,-1
248,48,37,27,11,75%,156,27%,9,2,7
248,36,28,16,8,81%,164,24%,3,0,3
248,47,39,8,8,68%,150,34%,8,5,3
248,36,21,8,15,78%,165,19%,8,5,3
248,58,35,3,23,72%,149,22%,15,11,4
249,59,54,13,5,66%,162,31%,13,9,4
249,48,34,10,14,75%,164,23%,4,2,2
249,15,14,7,1,89%,160,29%,1,1,0
249,19,13,4,6,71%,165,40%,4,0,4
249,56,57,9,-1,68%,159,36%,20,13,7
249,34,21,8,13,86%,170,20%,3,4,-1
249,30,23,10,7,74%,171,19%,4,6,-2
250,46,36,16,10,77%,149,20%,3,5,-2
250,36,21,5,15,79%,166,35%,5,2,3
250,37,26,13,11,82%,165,28%,2,4,-2
250,29,35,8,-6,76%,156,17%,7,10,-3
250,20,17,1,3,55%,162,39%,4,9,-5
250,36,32,7,4,62%,171,21%,7,5,2
250,22,15,6,7,83%,169,46%,1,1,0
250,52,33,16,19,74%,159,24%,10,3,7
250,91,87,23,4,67%,164,29%,27,24,3
250,58,44,10,14,70%,156,29%,11,6,5
250,43,34,19,9,71%,150,28%,7,1,6
250,50,43,21,7,76%,167,27%,13,7,6
251,40,28,9,12,73%,169,33%,12,3,9
251,37,20,12,17,83%,170,32%,3,3,0
251,42,29,2,13,72%,171,23%,7,1,6
251,35,25,24,10,79%,160,31%,5,1,4
251,39,23,15,16,77%,150,32%,2,3,-1
251,27,13,19,14,94%,162,31%,4,0,4
251,17,11,7,6,85%,174,22%,1,1,0
252,55,49,12,6,73%,163,27%,10,6,4
252,34,21,6,13,65%,171,15%,3,5,-2
252,34,31,16,3,74%,188,20%,3,6,-3
252,60,48,13,12,77%,169,30%,10,7,3
252,46,35,16,11,85%,173,44%,4,3,1
253,55,41,11,14,67%,156,25%,6,6,0
253,62,54,13,8,63%,160,34%,11,12,-1
253,98,68,41,30,79%,159,29%,10,6,4
253,29,14,14,15,90%,159,17%,3,2,1
253,28,15,20,13,87%,171,28%,3,0,3
253,50,41,22,9,85%,147,19%,12,6,6
253,34,29,4,5,64%,168,31%,4,3,1
254,59,46,24,13,76%,163,39%,4,2,2
254,44,31,16,13,71%,165,30%,6,2,4
254,70,52,4,18,64%,149,35%,11,12,-1
254,54,53,10,1,70%,157,31%,14,8,6
254,37,35,9,2,77%,169,26%,7,9,-2
255,42,31,8,11,73%,151,7%,9,8,1
255,57,45,18,12,72%,173,25%,10,7,3
255,34,32,7,2,74%,160,17%,10,4,6
255,35,24,6,11,74%,148,16%,8,4,4
255,39,29,9,10,76%,169,33%,10,4,6
255,29,13,16,16,91%,161,22%,4,0,4
255,39,25,14,14,76%,171,26%,3,4,-1
255,55,53,6,2,61%,157,28%,20,7,13
256,57,50,14,7,68%,170,29%,8,9,-1
256,20,10,6,10,75%,170,25%,1,1,0
256,36,33,11,3,65%,163,23%,10,9,1
256,49,37,12,12,73%,156,24%,6,7,-1
256,37,21,13,16,77%,159,29%,6,3,3
256,67,46,15,21,78%,163,23%,11,11,0
256,38,20,14,18,84%,158,26%,5,3,2
257,32,31,5,1,64%,156,27%,8,9,-1
257,19,15,3,4,65%,158,26%,7,1,6
257,38,22,17,16,85%,159,34%,2,2,0
257,36,25,8,11,82%,166,23%,6,4,2
257,51,43,29,8,75%,167,23%,8,2,6
257,53,45,26,8,75%,176,31%,6,4,2
257,37,29,5,8,79%,161,36%,9,1,8
257,17,19,10,-2,67%,185,21%,2,2,0
257,37,28,9,9,74%,161,19%,9,3,6
257,45,43,35,2,89%,168,23%,7,4,3
258,44,28,15,16,75%,177,41%,2,3,-1
258,37,17,7,20,84%,165,32%,4,1,3
258,34,30,9,4,68%,175,20%,11,8,3
258,36,32,4,4,73%,164,39%,10,1,9
259,32,25,13,7,72%,170,33%,9,3,6
259,36,38,13,-2,71%,174,24%,11,6,5
259,25,23,5,2,77%,168,29%,4,3,1
259,36,34,7,2,68%,167,30%,7,4,3
259,43,21,17,22,82%,182,39%,3,1,2
259,36,32,10,4,70%,171,18%,5,4,1
259,84,59,20,25,70%,165,31%,18,9,9
259,37,22,15,15,79%,188,37%,2,1,1
259,48,31,11,17,75%,162,15%,9,7,2
259,29,19,9,10,87%,167,12%,4,1,3
260,63,43,17,20,79%,164,24%,15,9,6
260,42,33,16,9,80%,178,19%,5,6,-1
260,28,17,0,11,79%,171,37%,7,5,2
260,35,19,6,16,89%,148,33%,4,1,3
260,30,27,4,3,57%,164,30%,10,9,1
260,42,28,9,14,78%,170,31%,7,3,4
260,40,36,6,4,72%,169,26%,7,6,1
260,62,43,8,19,67%,164,31%,10,5,5
261,36,16,16,20,81%,170,28%,4,3,1
261,34,28,10,6,71%,163,20%,5,4,1
261,36,16,16,20,81%,170,28%,4,3,1
261,56,43,8,13,79%,155,23%,11,8,3
261,15,16,6,-1,65%,188,32%,1,1,0
261,49,47,10,2,69%,171,25%,12,13,-1
261,73,64,15,9,66%,180,26%,17,17,0
261,43,29,10,14,65%,165,28%,5,6,-1
261,20,10,9,10,90%,166,20%,5,0,5
262,24,16,3,8,73%,158,27%,5,1,4
262,44,43,5,1,73%,158,31%,11,8,3
262,16,17,11,-1,76%,183,26%,1,3,-2
262,26,15,4,11,79%,170,18%,3,1,2
263,51,36,6,15,65%,167,33%,9,9,0
263,55,37,22,18,76%,168,22%,9,3,6
263,59,43,14,16,73%,160,22%,5,3,2
263,33,16,8,17,80%,162,34%,7,5,2
263,61,53,13,8,74%,169,34%,9,6,3
263,55,37,10,18,77%,163,26%,15,7,8
263,40,29,5,11,76%,166,34%,14,7,7
263,54,30,8,24,85%,172,19%,8,1,7
264,60,48,9,12,78%,163,27%,12,6,6
264,109,81,29,28,74%,173,17%,7,8,-1
264,24,14,4,10,71%,173,35%,1,4,-3
264,19,16,7,3,82%,193,23%,2,3,-1
264,21,13,4,8,82%,183,32%,2,0,2
264,44,38,20,6,69%,180,19%,11,11,0
264,40,26,3,14,68%,170,22%,9,9,0
264,40,30,14,10,84%,184,22%,7,5,2
265,36,25,5,11,82%,164,21%,12,6,6
265,45,32,10,13,69%,167,26%,13,8,5
265,61,53,26,8,77%,180,22%,9,9,0
265,20,22,10,-2,77%,174,20%,9,5,4
265,37,23,11,14,82%,181,35%,3,2,1
265,61,53,13,8,69%,170,31%,17,7,10
266,48,31,9,17,73%,162,29%,12,9,3
266,19,13,3,6,68%,147,41%,1,1,0
266,34,21,16,13,82%,151,33%,5,0,5
266,19,9,5,10,78%,204,50%,0,1,-1
266,35,19,7,16,94%,180,37%,3,4,-1
266,37,29,11,8,78%,183,26%,4,3,1
266,42,25,7,17,70%,161,27%,6,4,2
267,55,36,9,19,71%,159,20%,12,5,7
267,56,40,8,16,71%,168,35%,14,11,3
267,32,30,8,2,73%,168,15%,6,6,0
268,41,30,10,11,73%,183,24%,11,4,7
268,16,16,3,0,83%,161,50%,6,1,5
268,43,28,3,15,71%,175,25%,12,8,4
268,58,50,8,8,72%,179,35%,16,11,5
268,61,57,10,4,65%,171,32%,16,12,4
268,42,28,7,14,68%,164,32%,6,2,4
269,109,88,21,21,75%,168,19%,23,18,5
269,36,29,15,7,78%,170,22%,7,3,4
269,66,55,11,11,69%,166,21%,16,12,4
269,13,12,1,1,80%,176,19%,1,0,1
269,65,43,8,22,70%,160,31%,17,11,6
270,19,15,8,4,76%,188,27%,0,0,0
270,38,30,13,8,71%,162,32%,4,2,2
270,42,32,6,10,80%,176,27%,9,4,5
270,37,27,4,10,66%,188,30%,5,8,-3
270,80,54,13,26,80%,161,27%,22,3,19
270,51,45,8,6,68%,172,43%,11,9,2
271,58,39,22,19,77%,188,28%,7,3,4
272,40,26,26,14,86%,184,30%,2,5,-3
272,66,49,15,17,76%,184,30%,9,8,1
272,36,23,5,13,74%,168,29%,11,5,6
272,33,20,8,13,86%,171,22%,4,1,3
272,42,31,15,11,76%,175,31%,4,5,-1
272,17,16,4,1,68%,174,23%,5,1,4
272,71,55,18,16,73%,182,24%,13,10,3
272,35,26,11,9,79%,159,21%,7,4,3
272,39,33,12,6,74%,171,19%,4,5,-1
273,33,21,13,12,83%,188,15%,8,3,5
273,36,27,8,9,79%,162,29%,6,5,1
273,61,46,17,15,74%,192,24%,11,8,3
273,38,19,9,19,79%,174,25%,10,3,7
274,41,30,13,11,84%,180,20%,1,1,0
274,67,55,21,12,75%,182,26%,7,6,1
274,34,22,11,12,83%,170,18%,9,3,6
275,40,24,11,16,78%,167,23%,4,3,1
275,52,41,9,11,76%,178,26%,12,6,6
275,35,19,12,16,75%,171,36%,5,5,0
275,54,36,12,18,69%,175,23%,11,10,1
276,42,25,16,17,83%,170,30%,3,3,0
276,36,17,6,19,81%,170,25%,2,1,1
276,59,51,12,8,72%,170,22%,13,7,6
276,66,45,13,21,74%,189,26%,5,7,-2
276,71,50,22,21,74%,174,20%,20,9,11
277,70,49,9,21,75%,169,26%,14,6,8
277,21,16,1,5,76%,180,34%,2,1,1
277,63,43,9,20,74%,183,32%,10,7,3
278,43,33,4,10,72%,183,25%,9,6,3
278,30,21,32,9,79%,166,27%,3,5,-2
278,70,54,26,16,79%,177,14%,8,3,5
278,34,31,11,3,74%,184,28%,6,3,3
278,41,33,11,8,77%,188,37%,15,3,12
278,21,16,0,5,68%,157,14%,8,3,5
279,41,27,6,14,78%,179,26%,5,3,2
280,48,31,10,17,76%,175,30%,8,3,5
280,41,32,10,9,72%,179,22%,9,8,1
280,75,41,27,34,86%,177,24%,8,6,2
280,38,29,1,9,63%,174,32%,9,10,-1
280,30,16,8,14,80%,177,31%,1,2,-1
280,40,26,20,14,88%,187,22%,2,3,-1
281,19,19,11,0,81%,193,19%,4,3,1
281,45,31,18,14,84%,185,36%,5,1,4
282,67,40,8,27,78%,182,27%,10,5,5
282,38,18,16,20,78%,179,22%,6,3,3
282,67,46,22,21,75%,195,36%,5,2,3
282,60,40,13,20,70%,178,22%,12,6,6
282,41,27,13,14,80%,181,30%,6,6,0
282,37,19,12,18,85%,179,21%,3,2,1
283,56,44,13,12,68%,185,26%,7,10,-3
283,63,42,7,21,77%,172,39%,15,11,4
283,40,28,6,12,76%,181,43%,5,4,1
283,42,32,7,10,78%,177,38%,7,6,1
283,62,45,9,17,69%,172,20%,20,9,11
283,63,40,7,23,71%,175,20%,18,6,12
284,37,23,15,14,86%,182,16%,3,2,1
284,38,19,10,19,83%,191,29%,4,4,0
284,37,27,9,10,82%,178,22%,8,7,1
284,33,29,6,4,74%,182,27%,8,4,4
284,61,40,19,21,82%,184,31%,7,3,4
285,43,21,15,22,86%,182,35%,7,1,6
285,35,30,4,5,74%,167,29%,12,3,9
285,76,56,19,20,70%,173,31%,11,7,4
285,67,43,11,24,81%,173,23%,29,6,23
285,44,32,9,12,77%,180,32%,9,4,5
286,33,30,5,3,63%,181,32%,10,8,2
286,18,11,5,7,78%,193,20%,4,3,1
286,34,26,4,8,80%,167,35%,5,0,5
286,34,22,10,12,75%,174,20%,10,3,7
287,27,20,10,7,77%,187,26%,4,6,-2
287,23,18,2,5,57%,182,29%,3,7,-4
287,40,23,6,17,84%,181,21%,6,4,2
288,43,27,5,16,90%,190,40%,3,2,1
288,67,43,11,24,75%,188,23%,18,12,6
288,41,23,12,18,84%,185,36%,4,3,1
288,47,33,6,14,81%,170,24%,13,5,8
289,22,21,4,1,58%,181,34%,8,6,2
290,45,27,10,18,79%,193,34%,8,7,1
290,41,38,9,3,65%,172,33%,8,11,-3
290,39,24,18,15,82%,209,28%,5,4,1
291,78,50,13,28,73%,174,22%,11,5,6
291,46,29,9,17,75%,184,23%,6,7,-1
291,39,20,15,19,81%,194,33%,2,0,2
291,37,19,17,18,70%,185,18%,5,3,2
291,44,24,23,20,83%,193,26%,8,2,6
292,37,23,5,14,81%,181,23%,10,7,3
292,50,28,3,22,78%,183,30%,11,3,8
292,41,32,11,9,80%,176,47%,8,1,7
292,70,53,12,17,77%,186,26%,14,10,4
293,46,27,6,19,70%,184,34%,10,5,5
294,23,15,5,8,77%,173,28%,9,3,6
295,20,17,10,3,86%,195,30%,2,1,1
295,41,24,9,17,84%,194,23%,5,1,4
296,44,29,9,15,70%,185,22%,9,7,2
296,69,41,8,28,77%,184,29%,12,10,2
296,14,7,7,7,100%,186,31%,4,1,3
297,39,33,8,6,64%,171,13%,6,6,0
298,22,15,4,7,90%,186,42%,2,0,2
298,38,16,9,22,80%,191,26%,4,2,2
299,46,28,12,18,75%,197,25%,9,6,3
299,47,32,8,15,62%,186,53%,7,7,0
299,23,9,1,14,85%,181,16%,2,2,0
300,38,27,5,11,78%,184,24%,9,6,3
300,40,22,15,18,95%,188,18%,8,1,7
300,43,34,16,9,82%,197,23%,9,7,2
301,40,24,4,16,78%,169,19%,9,5,4
301,35,15,8,20,90%,191,24%,5,4,1
302,58,42,16,16,78%,193,34%,16,5,11
302,76,48,12,28,72%,183,24%,13,9,4
303,23,18,12,5,79%,205,29%,3,1,2
304,43,28,23,15,81%,199,28%,9,4,5
305,37,19,15,18,86%,196,43%,5,2,3
305,38,10,7,28,94%,206,30%,6,1,5
306,38,22,7,16,78%,192,27%,9,4,5
306,59,33,4,26,80%,187,26%,17,5,12
307,45,21,11,24,74%,190,36%,4,5,-1
307,44,23,19,21,85%,203,29%,5,0,5
310,34,21,23,13,81%,197,34%,3,1,2
311,34,20,10,14,80%,213,24%,7,3,4
313,46,32,16,14,86%,192,23%,7,4,3
314,40,29,8,11,71%,197,27%,15,9,6
314,57,36,10,21,80%,197,27%,11,6,5
314,47,29,10,18,72%,208,24%,10,3,7
316,43,24,7,19,88%,214,22%,6,5,1
318,52,26,4,26,70%,193,28%,11,6,5
318,52,26,4,26,70%,193,28%,11,6,5
320,46,29,6,17,80%,197,27%,9,2,7
320,49,24,25,25,84%,204,24%,8,3,5
321,46,33,8,13,74%,205,26%,9,3,6
324,46,36,4,10,68%,192,30%,6,8,-2
324,81,45,16,36,81%,206,32%,14,7,7
324,18,7,7,11,88%,198,33%,1,1,0
325,44,21,8,23,81%,212,38%,9,3,6
325,49,30,3,19,73%,201,24%,6,5,1
326,44,17,8,27,86%,199,17%,7,2,5
328,70,36,21,34,85%,195,19%,11,7,4
331,46,20,15,26,84%,208,19%,5,0,5
331,60,29,16,31,86%,195,29%,8,2,6
332,24,17,4,7,71%,228,44%,3,2,1
332,41,19,13,22,86%,221,22%,9,2,7
339,25,16,3,9,71%,218,20%,3,4,-1
342,36,25,3,11,63%,196,23%,11,6,5
343,93,57,13,36,74%,222,38%,15,10,5
351,49,22,7,27,86%,224,26%,8,2,6
351,21,7,4,14,93%,235,31%,5,2,3
354,50,21,14,29,84%,247,24%,9,6,3
356,40,14,10,26,81%,217,24%,6,4,2
362,53,27,6,26,93%,220,45%,10,0,10
365,47,20,9,27,84%,213,17%,12,5,7
367,50,28,10,22,79%,226,32%,14,6,8
376,51,20,5,31,79%,236,22%,9,2,7
48,2,14,2,-12,27%,30,25%,1,2,-1
57,3,15,2,-12,44%,35,25%,0,3,-3
61,4,30,6,-26,32%,51,12%,2,7,-5
85,5,15,2,-10,47%,67,27%,0,5,-5
85,5,17,4,-12,47%,57,9%,0,2,-2
86,10,31,5,-21,37%,64,33%,0,10,-10
86,6,10,5,-4,72%,59,13%,1,2,-1
86,7,19,8,-12,65%,57,13%,2,5,-3
87,4,16,7,-12,56%,61,21%,0,2,-2
90,11,29,4,-18,43%,49,39%,1,4,-3
90,8,30,5,-22,40%,71,26%,3,7,-4
90,4,14,1,-10,27%,65,29%,0,4,-4
91,4,17,6,-13,44%,59,20%,1,6,-5
95,11,26,11,-15,59%,70,22%,1,2,-1
95,6,14,1,-8,50%,63,5%,0,4,-4
97,10,27,6,-17,45%,64,25%,0,5,-5
98,17,40,18,-23,63%,67,31%,3,7,-4
98,11,28,13,-17,71%,64,20%,0,4,-4
98,6,15,2,-9,47%,67,26%,3,2,1
100,11,30,7,-19,53%,67,20%,0,6,-6
101,6,16,1,-10,33%,59,24%,0,4,-4
103,7,14,3,-7,58%,71,30%,0,4,-4
103,7,16,14,-9,82%,72,15%,0,0,0
104,14,31,5,-17,60%,66,21%,2,5,-3
104,6,17,2,-11,59%,72,29%,0,2,-2
105,5,16,6,-11,50%,74,27%,1,1,0
109,6,15,3,-9,41%,65,14%,1,1,0
110,17,31,10,-14,57%,74,40%,1,5,-4
111,18,40,14,-22,53%,75,20%,5,3,2
111,14,29,6,-15,60%,78,25%,2,5,-3
111,22,40,10,-18,51%,78,34%,1,4,-3
112,9,17,5,-8,67%,84,26%,0,2,-2
114,13,37,6,-24,46%,87,28%,1,9,-8
114,8,15,5,-7,59%,65,14%,0,4,-4
115,11,17,11,-6,77%,78,33%,1,2,-1
117,18,35,9,-17,57%,93,19%,1,7,-6
117,9,15,2,-6,64%,83,19%,0,3,-3
117,16,26,12,-10,60%,78,21%,2,2,0
118,21,28,11,-7,72%,91,20%,0,4,-4
119,15,31,6,-16,51%,77,45%,1,3,-2
119,7,10,6,-3,76%,89,10%,0,1,-1
119,12,28,8,-16,52%,75,24%,1,5,-4
120,14,32,13,-18,50%,87,10%,0,3,-3
120,26,43,16,-17,63%,82,26%,3,6,-3
120,12,29,8,-17,67%,76,31%,3,6,-3
121,23,42,14,-19,56%,94,17%,3,5,-2
121,11,27,3,-16,50%,90,26%,0,1,-1
122,16,33,9,-17,63%,79,14%,1,5,-4
122,30,44,18,-14,64%,83,20%,2,2,0
122,6,14,4,-8,69%,72,13%,1,0,1
123,9,16,7,-7,62%,84,25%,0,2,-2
123,21,39,23,-18,72%,84,12%,2,2,0
123,6,13,2,-7,44%,87,19%,0,2,-2
123,8,14,12,-6,67%,75,17%,2,4,-2
124,15,26,6,-11,52%,88,25%,0,2,-2
124,5,19,4,-14,47%,91,9%,1,1,0
124,18,34,8,-16,59%,80,18%,1,3,-2
125,15,30,7,-15,56%,88,19%,2,3,-1
125,15,31,9,-16,58%,89,29%,1,1,0
125,21,31,9,-10,49%,88,18%,0,1,-1
126,19,29,12,-10,73%,96,26%,2,0,2
127,7,17,12,-10,55%,79,50%,0,2,-2
127,13,30,6,-17,48%,93,20%,0,5,-5
127,19,34,7,-15,56%,87,31%,3,4,-1
127,7,15,2,-8,41%,79,53%,1,7,-6
127,8,15,2,-7,38%,64,12%,1,1,0
128,6,16,5,-10,47%,96,20%,0,4,-4
129,19,20,9,-1,84%,96,25%,2,2,0
129,14,26,4,-12,50%,98,29%,1,2,-1
129,6,15,3,-9,69%,93,30%,0,2,-2
130,17,18,10,-1,81%,84,16%,0,2,-2
130,7,12,5,-5,75%,81,18%,0,1,-1
131,21,27,14,-6,66%,85,18%,3,2,1
131,14,29,5,-15,55%,82,20%,2,2,0
132,18,34,12,-16,65%,89,28%,1,4,-3
132,14,30,7,-16,46%,100,14%,1,3,-2
132,25,45,18,-20,55%,85,30%,5,7,-2
132,8,11,8,-3,68%,102,28%,0,3,-3
133,9,17,5,-8,67%,95,23%,1,2,-1
133,7,15,1,-8,50%,88,35%,2,3,-1
133,21,27,8,-6,63%,76,42%,4,2,2
134,7,10,8,-3,76%,95,18%,0,1,-1
134,6,15,4,-9,41%,82,15%,2,1,1
134,7,14,1,-7,40%,103,22%,0,0,0
135,8,12,11,-4,67%,105,15%,0,0,0
135,18,21,14,-3,81%,83,23%,0,0,0
135,21,23,14,-2,80%,79,26%,0,2,-2
135,19,28,7,-9,61%,93,21%,4,5,-1
135,18,31,10,-13,68%,104,14%,3,3,0
135,7,11,6,-4,81%,113,23%,1,3,-2
135,11,18,12,-7,83%,88,21%,1,2,-1
136,28,49,14,-21,55%,95,12%,3,5,-2
136,19,23,10,-4,73%,82,17%,3,5,-2
136,7,11,15,-4,84%,104,22%,1,1,0
136,18,29,2,-11,54%,87,40%,5,4,1
136,19,30,17,-11,76%,104,21%,2,5,-3
136,11,14,6,-3,59%,82,30%,1,2,-1
136,9,17,5,-8,57%,94,39%,2,2,0
137,20,38,12,-18,57%,98,16%,2,5,-3
137,16,31,12,-15,57%,114,35%,2,4,-2
138,17,28,4,-11,47%,84,29%,2,3,-1
138,11,18,5,-7,70%,102,21%,3,6,-3
139,15,30,7,-15,50%,111,21%,2,8,-6
139,10,10,6,0,74%,102,22%,1,0,1
139,31,41,23,-10,63%,96,18%,2,8,-6
139,11,33,18,-22,50%,101,18%,2,2,0
139,9,15,2,-6,58%,86,20%,0,2,-2
140,20,33,16,-13,71%,89,27%,1,4,-3
140,49,48,30,1,77%,84,15%,2,9,-7
140,20,33,3,-13,49%,102,18%,0,5,-5
140,20,32,1,-12,51%,90,38%,4,10,-6
140,25,45,17,-20,63%,93,31%,4,6,-2
141,19,33,6,-14,45%,105,45%,4,4,0
142,20,31,7,-11,63%,96,17%,2,2,0
142,13,12,3,1,71%,91,34%,0,3,-3
142,30,43,12,-13,57%,93,20%,3,2,1
142,7,9,5,-2,75%,91,18%,2,1,1
142,21,33,6,-12,59%,109,41%,2,10,-8
143,15,31,12,-16,70%,108,20%,2,3,-1
143,26,34,15,-8,62%,100,26%,2,2,0
143,15,28,4,-13,50%,107,36%,4,12,-8
143,27,38,15,-11,68%,97,25%,2,7,-5
143,27,41,9,-14,56%,103,24%,2,1,1
144,30,42,16,-12,65%,96,17%,2,5,-3
144,20,29,5,-9,63%,99,24%,5,1,4
144,9,10,8,-1,76%,103,14%,0,0,0
144,16,29,2,-13,42%,108,26%,3,9,-6
144,11,17,2,-6,59%,93,19%,0,4,-4
145,32,46,16,-14,67%,101,34%,5,5,0
145,15,14,3,1,69%,96,38%,1,1,0
145,9,13,0,-4,63%,101,19%,3,2,1
146,19,30,5,-11,49%,108,27%,2,6,-4
146,33,45,19,-12,63%,101,11%,3,11,-8
146,14,16,9,-2,69%,93,24%,1,2,-1
146,25,29,4,-4,73%,99,35%,2,7,-5
146,21,37,7,-16,46%,88,17%,4,14,-10
146,24,31,9,-7,74%,105,28%,1,3,-2
146,12,18,5,-6,62%,99,23%,0,2,-2
147,17,31,5,-14,53%,96,28%,5,7,-2
147,35,47,17,-12,68%,94,29%,3,9,-6
147,36,49,22,-13,69%,104,24%,2,6,-4
147,17,32,6,-15,58%,104,31%,2,12,-10
147,21,23,15,-2,64%,100,23%,2,1,1
147,23,27,14,-4,74%,97,26%,2,3,-1
147,24,37,9,-13,68%,102,11%,2,7,-5
148,33,49,15,-16,63%,103,36%,6,8,-2
148,20,27,9,-7,58%,93,21%,2,3,-1
148,7,15,4,-8,71%,103,23%,0,0,0
148,25,29,9,-4,70%,104,35%,5,4,1
148,15,26,5,-11,58%,87,22%,2,2,0
148,11,20,3,-9,48%,103,18%,0,5,-5
148,19,33,18,-14,59%,95,23%,3,4,-1
148,34,40,24,-6,68%,99,34%,3,1,2
148,7,14,5,-7,44%,111,24%,1,1,0
148,16,17,3,-1,65%,115,22%,4,6,-2
149,20,25,15,-5,83%,107,32%,0,3,-3
149,19,30,8,-11,63%,97,14%,3,3,0
149,17,23,12,-6,76%,103,15%,2,5,-3
149,9,16,5,-7,63%,115,15%,3,5,-2
149,16,30,9,-14,60%,110,19%,2,3,-1
149,35,46,20,-11,59%,99,33%,4,7,-3
149,11,17,6,-6,65%,110,22%,1,3,-2
150,40,50,22,-10,74%,96,17%,5,3,2
150,30,37,19,-7,65%,100,16%,2,5,-3
150,31,50,14,-19,66%,103,24%,4,4,0
150,28,47,5,-19,60%,112,29%,6,5,1
150,19,36,6,-17,60%,95,20%,4,6,-2
150,19,23,8,-4,74%,107,22%,5,5,0
150,21,33,4,-12,52%,99,24%,2,2,0
150,22,32,4,-10,59%,97,24%,3,6,-3
151,24,24,4,0,63%,95,36%,3,7,-4
151,16,29,3,-13,48%,91,26%,2,5,-3
152,28,42,5,-14,58%,105,24%,2,3,-1
152,9,14,4,-5,53%,99,18%,1,6,-5
152,21,21,7,0,76%,112,34%,3,1,2
152,10,17,5,-7,73%,100,17%,2,4,-2
153,21,35,8,-14,44%,99,32%,3,10,-7
153,26,26,20,0,82%,106,13%,0,5,-5
153,32,41,26,-9,72%,103,17%,3,4,-1
153,34,50,20,-16,67%,93,21%,4,5,-1
153,9,18,3,-9,53%,99,23%,1,7,-6
153,19,19,12,0,85%,110,29%,1,3,-2
153,18,29,2,-11,55%,93,26%,4,3,1
153,19,30,8,-11,71%,102,12%,6,7,-1
154,18,36,7,-18,61%,100,23%,1,8,-7
154,33,46,18,-13,69%,109,17%,5,7,-2
154,9,18,2,-9,42%,110,37%,1,3,-2
154,8,16,6,-8,53%,105,26%,0,4,-4
154,16,28,4,-12,53%,117,42%,5,2,3
154,29,44,21,-15,67%,97,22%,3,2,1
154,11,15,10,-4,71%,97,18%,2,3,-1
155,22,24,17,-2,85%,99,31%,0,0,0
155,22,35,13,-13,65%,103,26%,1,4,-3
155,28,26,10,2,77%,100,33%,5,2,3
155,18,27,9,-9,67%,98,14%,1,4,-3
155,16,30,6,-14,52%,100,24%,4,5,-1
155,19,30,8,-11,59%,113,25%,1,8,-7
155,8,13,2,-5,63%,107,18%,3,2,1
155,26,34,18,-8,70%,98,28%,1,3,-2
156,34,32,13,2,86%,95,19%,2,3,-1
156,23,24,17,-1,76%,110,15%,2,3,-1
156,8,15,4,-7,65%,102,25%,2,5,-3
156,32,47,10,-15,57%,102,28%,4,8,-4
157,11,19,9,-8,74%,108,16%,1,2,-1
157,22,17,16,5,77%,100,25%,0,0,0
157,29,34,16,-5,62%,106,24%,0,3,-3
157,18,16,13,2,82%,103,21%,3,0,3
157,27,28,4,-1,61%,98,31%,4,5,-1
157,29,42,8,-13,63%,107,24%,6,7,-1
157,9,14,2,-5,50%,97,21%,0,4,-4
158,34,45,15,-11,61%,102,25%,6,7,-1
158,23,26,14,-3,64%,109,43%,3,2,1
158,12,18,4,-6,71%,105,21%,0,2,-2
158,38,49,25,-11,77%,105,21%,7,2,5
158,12,19,3,-7,63%,98,15%,2,5,-3
159,46,57,26,-11,77%,106,23%,2,4,-2
159,34,50,15,-16,65%,108,17%,3,4,-1
159,41,52,15,-11,61%,102,20%,6,13,-7
159,17,27,5,-10,62%,109,26%,3,4,-1
159,9,16,2,-7,56%,92,26%,1,4,-3
159,22,36,4,-14,48%,110,20%,5,5,0
159,26,46,11,-20,63%,104,23%,2,5,-3
159,24,30,18,-6,73%,104,27%,1,2,-1
159,14,21,10,-7,69%,103,12%,2,1,1
160,51,55,16,-4,71%,114,27%,11,13,-2
160,43,56,20,-13,66%,109,28%,6,13,-7
160,38,49,16,-11,79%,110,28%,4,5,-1
160,18,28,1,-10,55%,98,37%,3,0,3
160,20,28,2,-8,69%,103,27%,6,3,3
160,23,32,9,-9,66%,118,21%,5,5,0
160,14,18,7,-4,65%,112,19%,2,1,1
160,11,8,4,3,74%,106,24%,2,2,0
160,7,14,4,-7,69%,105,29%,0,1,-1
161,26,27,13,-1,70%,110,19%,0,2,-2
161,34,42,22,-8,69%,96,39%,5,6,-1
161,34,39,19,-5,64%,110,21%,4,9,-5
161,10,17,4,-7,50%,106,27%,2,3,-1
161,10,14,2,-4,63%,107,33%,1,2,-1
161,30,35,9,-5,53%,109,41%,1,5,-4
162,9,18,6,-9,63%,114,21%,0,2,-2
162,29,33,17,-4,78%,111,25%,5,5,0
162,20,30,7,-10,58%,107,37%,1,6,-5
162,19,26,3,-7,65%,111,31%,1,2,-1
162,21,33,24,-12,73%,106,18%,1,4,-3
162,7,13,3,-6,73%,118,17%,0,1,-1
163,20,32,9,-12,68%,106,35%,1,4,-3
163,35,31,11,4,65%,110,19%,2,2,0
163,22,33,6,-11,50%,109,24%,4,4,0
163,19,29,6,-10,61%,107,35%,2,4,-2
163,34,44,21,-10,67%,109,29%,1,3,-2
163,26,21,17,5,83%,119,31%,1,0,1
163,33,45,10,-12,54%,113,36%,4,6,-2
163,27,35,13,-8,58%,105,24%,7,7,0
163,29,28,9,1,72%,102,21%,2,2,0
164,49,52,12,-3,80%,112,25%,9,8,1
164,39,56,18,-17,63%,117,30%,6,8,-2
164,23,31,4,-8,70%,109,31%,7,6,1
164,31,34,18,-3,74%,104,21%,1,0,1
164,40,40,11,0,72%,115,34%,3,4,-1
164,20,28,3,-8,57%,111,22%,2,4,-2
165,25,34,10,-9,62%,98,20%,3,6,-3
165,34,45,16,-11,67%,108,25%,5,1,4
165,13,17,8,-4,71%,99,36%,0,2,-2
165,31,47,18,-16,68%,118,25%,4,7,-3
165,12,15,5,-3,67%,107,21%,4,1,3
166,8,9,6,-1,71%,121,26%,2,0,2
166,31,31,15,0,62%,104,33%,4,4,0
166,38,42,32,-4,84%,117,24%,2,1,1
166,25,34,11,-9,70%,109,38%,5,6,-1
167,28,37,12,-9,69%,113,35%,2,6,-4
167,25,42,10,-17,55%,112,31%,5,9,-4
167,29,35,10,-6,58%,123,19%,5,6,-1
167,30,35,8,-5,74%,105,24%,9,7,2
167,10,9,2,1,82%,115,26%,3,0,3
167,10,13,4,-3,65%,109,40%,0,0,0
167,10,15,3,-5,63%,107,27%,2,4,-2
167,11,18,5,-7,57%,115,40%,1,1,0
167,29,38,14,-9,62%,110,26%,4,4,0
167,21,35,4,-14,55%,107,18%,8,12,-4
168,20,35,4,-15,59%,111,31%,3,7,-4
168,51,54,16,-3,77%,104,36%,6,3,3
168,34,39,20,-5,74%,115,22%,4,6,-2
168,30,46,12,-16,62%,120,19%,8,7,1
168,31,38,13,-7,69%,106,20%,4,9,-5
168,46,49,18,-3,70%,125,20%,7,5,2
168,27,30,8,-3,56%,111,21%,2,3,-1
168,34,46,26,-12,69%,109,15%,5,8,-3
168,39,48,16,-9,69%,110,26%,2,7,-5
168,28,33,10,-5,64%,114,25%,0,3,-3
168,9,16,0,-7,44%,95,31%,3,5,-2
168,23,30,12,-7,64%,114,18%,3,2,1
169,23,36,22,-13,72%,121,22%,5,6,-1
169,29,33,10,-4,76%,115,28%,2,2,0
169,30,49,19,-19,55%,118,29%,3,6,-3
169,26,35,13,-9,70%,122,22%,5,5,0
169,24,31,5,-7,69%,116,16%,1,3,-2
169,21,31,24,-10,73%,116,18%,2,10,-8
169,29,38,11,-9,74%,119,25%,2,3,-1
169,19,27,12,-8,62%,102,23%,2,4,-2
169,40,51,12,-11,55%,120,15%,7,9,-2
169,39,42,12,-3,75%,112,29%,5,6,-1
169,33,43,6,-10,52%,131,46%,6,8,-2
169,23,21,13,2,79%,116,23%,1,1,0
170,37,43,11,-6,68%,112,25%,7,11,-4
170,20,30,5,-10,53%,114,12%,1,5,-4
170,28,34,14,-6,59%,107,26%,1,2,-1
170,30,38,18,-8,80%,119,25%,1,3,-2
170,10,12,1,-2,81%,117,29%,1,0,1
170,13,18,9,-5,68%,111,30%,1,4,-3
171,26,32,12,-6,67%,112,41%,1,4,-3
171,12,15,7,-3,65%,122,26%,1,1,0
171,24,35,5,-11,51%,111,24%,5,10,-5
171,35,46,24,-11,72%,115,22%,3,3,0
171,39,43,28,-4,68%,114,24%,2,3,-1
171,33,34,10,-1,69%,113,30%,4,2,2
172,23,24,17,-1,79%,129,19%,2,4,-2
172,31,35,12,-4,70%,113,24%,3,3,0
172,12,13,1,-1,61%,113,25%,2,1,1
172,18,29,5,-11,52%,114,18%,2,2,0
172,17,31,5,-14,49%,121,20%,3,5,-2
172,23,36,8,-13,60%,122,21%,8,13,-5
172,17,27,8,-10,60%,105,29%,0,4,-4
172,15,17,3,-2,77%,114,20%,2,2,0
172,9,7,8,2,93%,127,16%,1,0,1
173,25,31,2,-6,49%,118,23%,3,7,-4
173,28,34,16,-6,76%,108,29%,4,1,3
173,29,33,14,-4,67%,121,19%,5,8,-3
173,23,21,10,2,68%,107,18%,3,2,1
173,42,52,19,-10,61%,113,29%,6,7,-1
173,23,17,7,6,91%,125,33%,3,2,1
173,24,36,5,-12,60%,114,27%,3,9,-6
173,23,29,14,-6,73%,114,24%,0,1,-1
173,15,16,7,-1,64%,97,13%,4,1,3
173,12,15,6,-3,62%,110,19%,1,1,0
173,25,38,12,-13,66%,126,20%,2,10,-8
174,39,51,14,-12,67%,120,25%,4,2,2
174,20,31,5,-11,51%,120,28%,3,4,-1
174,30,39,6,-9,68%,132,30%,4,5,-1
174,42,49,17,-7,70%,116,29%,4,6,-2
174,38,45,12,-7,71%,123,38%,5,6,-1
174,17,16,4,1,75%,118,20%,1,2,-1
174,21,13,18,8,88%,122,22%,0,2,-2
174,28,38,6,-10,57%,119,26%,4,4,0
175,34,37,19,-3,67%,119,17%,5,8,-3
175,33,42,23,-9,65%,109,20%,4,2,2
175,37,41,12,-4,68%,115,31%,7,7,0
175,23,20,16,3,77%,127,36%,0,3,-3
175,45,46,13,-1,71%,117,38%,4,5,-1
175,33,37,20,-4,67%,113,21%,2,8,-6
175,41,51,21,-10,65%,113,21%,6,4,2
175,42,46,27,-4,71%,124,18%,2,4,-2
175,40,43,15,-3,67%,129,31%,3,5,-2
175,9,15,3,-6,38%,110,18%,2,1,1
175,14,13,7,1,76%,113,30%,1,0,1
176,31,38,6,-7,62%,106,27%,8,8,0
176,50,52,12,-2,73%,113,26%,8,9,-1
176,25,29,14,-4,73%,120,28%,5,3,2
176,42,50,26,-8,70%,112,25%,2,7,-5
176,14,17,7,-3,82%,126,11%,1,0,1
177,34,46,10,-12,55%,119,29%,10,11,-1
177,23,13,17,10,88%,113,31%,2,0,2
177,26,38,12,-12,57%,128,17%,3,2,1
177,38,35,14,3,71%,114,28%,8,5,3
177,39,37,18,2,66%,119,24%,4,3,1
177,10,16,2,-6,53%,118,31%,1,3,-2
177,10,6,13,4,88%,108,10%,0,1,-1
178,28,28,10,0,74%,112,32%,5,3,2
178,23,33,9,-10,64%,118,35%,3,1,2
178,20,26,10,-6,62%,117,32%,0,1,-1
178,34,43,33,-9,71%,130,21%,3,3,0
178,20,32,4,-12,57%,124,32%,4,5,-1
178,45,46,15,-1,75%,127,50%,2,3,-1
178,42,46,27,-4,71%,120,28%,4,6,-2
178,42,54,10,-12,54%,117,21%,10,10,0
178,37,46,19,-9,68%,124,25%,2,6,-4
178,14,16,13,-2,69%,135,35%,3,1,2
178,26,26,5,0,67%,123,17%,5,7,-2
178,25,30,10,-5,64%,113,37%,6,5,1
179,25,37,16,-12,72%,113,23%,0,3,-3
179,35,38,14,-3,72%,111,30%,1,3,-2
179,31,49,13,-18,59%,116,26%,6,8,-2
179,35,36,18,-1,76%,131,22%,1,4,-3
179,26,40,8,-14,62%,115,30%,9,14,-5
179,39,41,21,-2,78%,121,26%,2,7,-5
179,15,9,13,6,86%,106,17%,0,0,0
179,19,32,3,-13,55%,121,32%,6,3,3
179,29,30,17,-1,83%,115,16%,0,1,-1
179,24,28,7,-4,68%,117,21%,3,1,2
180,21,28,6,-7,57%,132,31%,1,1,0
180,25,33,11,-8,63%,117,30%,7,7,0
180,46,52,8,-6,68%,117,17%,11,11,0
180,49,44,26,5,80%,123,17%,6,2,4
180,45,50,15,-5,61%,124,18%,1,8,-7
180,28,34,9,-6,72%,125,29%,3,3,0
180,39,46,5,-7,67%,124,34%,10,11,-1
180,31,28,36,3,83%,119,18%,2,3,-1
180,22,11,17,11,90%,131,28%,2,1,1
180,12,19,9,-7,62%,121,22%,1,0,1
181,31,30,5,1,66%,124,36%,1,3,-2
181,40,53,20,-13,63%,127,22%,4,8,-4
181,27,35,12,-8,77%,137,19%,0,1,-1
181,41,44,10,-3,55%,127,25%,2,8,-6
181,25,25,18,0,74%,120,20%,0,1,-1
181,36,37,11,-1,59%,128,33%,2,4,-2
182,40,43,5,-3,66%,112,33%,5,3,2
182,26,32,8,-6,66%,118,26%,1,1,0
182,25,34,8,-9,63%,115,25%,2,2,0
183,22,20,18,2,86%,114,19%,4,2,2
183,36,41,15,-5,66%,121,20%,6,11,-5
183,29,31,9,-2,63%,119,26%,2,3,-1
183,36,47,9,-11,62%,120,28%,5,5,0
183,25,28,13,-3,79%,123,24%,2,1,1
183,44,55,11,-11,59%,124,28%,6,8,-2
183,7,14,5,-7,63%,138,33%,1,1,0
183,45,53,16,-8,70%,135,30%,7,8,-1
183,37,41,8,-4,58%,138,22%,2,6,-4
183,29,47,13,-18,60%,126,20%,7,12,-5
183,28,23,18,5,72%,120,27%,6,1,5
183,29,23,16,6,90%,117,21%,2,3,-1
184,41,38,12,3,78%,123,28%,4,3,1
184,36,29,18,7,82%,122,27%,4,3,1
184,26,34,6,-8,59%,128,38%,4,2,2
184,39,44,24,-5,70%,125,25%,6,5,1
184,28,35,11,-7,69%,124,18%,3,5,-2
184,18,29,6,-11,61%,122,25%,5,3,2
184,44,49,11,-5,64%,116,14%,7,3,4
184,26,30,3,-4,56%,111,10%,5,8,-3
184,36,39,18,-3,76%,128,19%,2,4,-2
184,13,5,1,8,81%,124,34%,1,1,0
184,17,16,5,1,81%,122,28%,1,1,0
184,11,16,1,-5,56%,101,14%,5,1,4
184,12,8,11,4,89%,122,26%,0,0,0
185,49,49,22,0,68%,120,26%,2,4,-2
185,39,43,12,-4,71%,136,37%,5,2,3
185,27,22,16,5,74%,104,29%,4,3,1
185,24,27,15,-3,88%,138,17%,5,2,3
185,29,31,9,-2,61%,118,26%,8,9,-1
185,39,32,25,7,72%,113,11%,4,2,2
185,14,13,6,1,77%,128,19%,0,2,-2
186,40,35,31,5,78%,123,29%,5,3,2
186,31,37,10,-6,66%,122,31%,2,4,-2
186,35,36,19,-1,82%,113,25%,4,3,1
186,30,32,11,-2,70%,130,18%,6,5,1
186,13,16,6,-3,55%,133,23%,2,2,0
186,38,34,7,4,65%,110,30%,11,14,-3
186,36,46,11,-10,61%,119,29%,14,10,4
186,22,30,11,-8,79%,137,25%,2,2,0
187,25,30,15,-5,68%,126,28%,3,4,-1
187,28,33,16,-5,72%,130,25%,1,3,-2
187,53,49,26,4,79%,112,23%,3,3,0
187,31,36,12,-5,73%,124,20%,10,11,-1
187,37,41,21,-4,71%,122,24%,5,2,3
187,33,41,17,-8,70%,127,21%,4,2,2
187,31,30,11,1,69%,122,46%,3,2,1
187,30,33,21,-3,72%,132,34%,1,7,-6
187,22,21,7,1,79%,123,27%,3,7,-4
187,13,13,5,0,74%,121,30%,2,0,2
187,32,39,8,-7,58%,127,27%,1,8,-7
187,13,19,7,-6,57%,127,29%,3,3,0
188,55,51,22,4,81%,125,24%,4,1,3
188,44,51,7,-7,55%,117,34%,8,15,-7
188,30,33,18,-3,88%,127,27%,2,1,1
188,11,16,2,-5,76%,109,16%,1,2,-1
188,24,15,7,9,85%,118,26%,5,1,4
188,29,28,12,1,57%,119,32%,2,2,0
188,24,25,5,-1,69%,129,23%,2,3,-1
188,27,20,8,7,65%,137,41%,1,4,-3
188,11,16,3,-5,50%,116,32%,0,5,-5
189,26,29,7,-3,61%,133,21%,4,5,-1
189,33,34,19,-1,78%,126,17%,4,5,-1
189,38,44,14,-6,61%,115,21%,3,6,-3
189,46,52,11,-6,67%,125,30%,5,4,1
189,14,16,1,-2,48%,112,40%,1,5,-4
189,32,29,21,3,74%,121,29%,4,2,2
189,19,29,5,-10,58%,119,32%,3,6,-3
189,43,53,19,-10,71%,127,20%,3,8,-5
189,17,15,3,2,64%,133,36%,2,0,2
189,9,9,4,0,81%,131,40%,2,0,2
189,10,15,4,-5,63%,118,17%,0,0,0
190,30,33,22,-3,83%,133,23%,5,2,3
190,43,44,29,-1,74%,133,27%,4,7,-3
190,14,8,2,6,82%,146,56%,1,1,0
190,16,19,8,-3,71%,118,36%,3,2,1
190,43,44,13,-1,75%,123,29%,6,4,2
190,31,39,9,-8,60%,129,16%,8,12,-4
190,24,23,22,1,83%,116,31%,2,1,1
190,26,16,7,10,90%,113,38%,2,4,-2
190,25,26,14,-1,80%,125,13%,4,4,0
190,39,34,11,5,63%,123,22%,2,5,-3
190,10,13,9,-3,72%,137,15%,1,4,-3
190,31,26,7,5,67%,126,34%,2,2,0
191,50,60,15,-10,64%,127,25%,8,16,-8
191,47,51,32,-4,71%,119,21%,1,5,-4
191,12,13,3,-1,65%,136,38%,0,1,-1
191,22,21,9,1,61%,124,29%,3,3,0
191,38,42,8,-4,69%,127,25%,2,4,-2
191,27,23,13,4,76%,124,23%,8,6,2
191,16,28,4,-12,53%,118,25%,4,5,-1
191,27,31,10,-4,73%,127,34%,1,1,0
192,11,11,10,0,78%,129,25%,0,1,-1
192,35,29,15,6,71%,127,22%,0,3,-3
192,26,28,17,-2,77%,125,30%,4,2,2
192,43,43,15,0,75%,121,37%,7,6,1
192,36,43,16,-7,60%,109,17%,7,8,-1
192,12,8,5,4,88%,117,20%,1,3,-2
193,30,23,6,7,73%,132,32%,5,3,2
193,46,42,25,4,79%,128,19%,4,4,0
193,52,58,27,-6,70%,132,29%,5,6,-1
193,36,37,34,-1,78%,122,26%,6,8,-2
193,42,50,29,-8,75%,124,33%,2,5,-3
193,35,36,29,-1,80%,134,21%,4,2,2
193,11,9,3,2,81%,116,45%,2,3,-1
193,24,28,10,-4,78%,124,24%,9,4,5
194,28,23,10,5,76%,129,31%,1,3,-2
194,29,33,16,-4,72%,123,24%,5,4,1
194,28,36,10,-8,60%,132,21%,3,8,-5
194,11,16,7,-5,63%,138,20%,1,2,-1
194,22,32,8,-10,62%,142,22%,1,2,-1
194,37,33,19,4,80%,129,38%,5,3,2
195,25,27,15,-2,70%,129,25%,2,2,0
195,32,35,8,-3,67%,133,21%,5,4,1
195,22,25,6,-3,65%,130,31%,0,2,-2
195,29,19,17,10,84%,133,42%,1,2,-1
195,50,57,32,-7,79%,134,22%,8,13,-5
195,44,42,22,2,75%,132,25%,6,4,2
195,28,35,8,-7,65%,120,13%,11,14,-3
195,48,48,17,0,68%,139,29%,3,8,-5
195,28,15,7,13,88%,124,39%,2,0,2
195,27,31,28,-4,75%,146,28%,2,2,0
195,32,29,15,3,72%,134,33%,6,5,1
195,47,41,17,6,67%,140,22%,4,2,2
195,14,11,10,3,78%,113,22%,2,1,1
195,14,16,2,-2,68%,107,12%,5,4,1
196,29,31,8,-2,59%,124,22%,3,4,-1
196,33,34,7,-1,71%,125,28%,4,6,-2
196,43,30,9,13,78%,122,29%,4,5,-1
196,14,16,4,-2,76%,126,19%,3,5,-2
196,29,29,5,0,61%,109,13%,6,5,1
196,37,38,23,-1,68%,131,28%,3,6,-3
196,13,9,9,4,78%,101,35%,2,1,1
197,43,34,28,9,80%,137,26%,4,2,2
197,15,14,6,1,59%,126,15%,1,4,-3
197,12,5,6,7,80%,117,35%,2,1,1
197,10,12,1,-2,53%,126,32%,2,5,-3
197,11,11,8,0,69%,125,30%,2,2,0
198,26,31,9,-5,66%,129,18%,8,8,0
198,30,32,17,-2,70%,124,21%,3,3,0
198,53,49,14,4,81%,132,14%,7,3,4
198,43,53,9,-10,63%,125,27%,15,14,1
198,32,29,16,3,80%,121,26%,4,3,1
198,20,22,2,-2,73%,130,29%,1,3,-2
199,50,42,26,8,74%,130,35%,3,6,-3
199,39,43,30,-4,77%,139,16%,3,3,0
199,49,42,15,7,75%,127,20%,5,2,3
199,29,34,7,-5,73%,130,41%,5,6,-1
199,25,29,8,-4,76%,130,32%,3,1,2
199,14,14,0,0,56%,126,22%,1,0,1
200,42,35,22,7,74%,129,28%,3,1,2
200,34,40,13,-6,64%,132,25%,2,4,-2
200,47,52,20,-5,69%,139,22%,6,11,-5
200,13,15,6,-2,74%,126,19%,1,2,-1
200,13,17,6,-4,58%,124,21%,1,2,-1
200,29,34,1,-5,55%,140,21%,5,3,2
200,22,31,8,-9,62%,137,22%,3,9,-6
200,31,36,7,-5,59%,143,30%,6,12,-6
200,28,19,11,9,79%,146,29%,0,5,-5
201,29,22,10,7,80%,136,24%,3,2,1
201,41,31,8,10,78%,140,24%,5,4,1
201,41,39,15,2,67%,129,31%,8,7,1
201,49,50,11,-1,72%,126,26%,6,7,-1
201,32,35,9,-3,70%,132,26%,3,1,2
201,34,41,9,-7,66%,132,25%,6,4,2
201,26,25,2,1,69%,118,17%,6,6,0
201,44,40,18,4,72%,128,31%,4,1,3
201,42,42,12,0,67%,140,27%,7,10,-3
202,49,54,12,-5,66%,134,24%,9,7,2
202,52,39,23,13,81%,141,31%,6,2,4
202,28,30,10,-2,63%,130,32%,1,2,-1
202,34,37,8,-3,57%,131,26%,6,4,2
202,24,34,9,-10,68%,141,22%,1,4,-3
203,43,51,10,-8,62%,134,40%,10,11,-1
203,28,15,2,13,74%,110,21%,8,5,3
203,30,21,7,9,79%,128,36%,10,2,8
203,34,36,8,-2,57%,132,28%,3,2,1
203,16,16,3,0,68%,128,24%,4,0,4
203,12,7,3,5,80%,146,30%,2,2,0
204,31,41,5,-10,63%,140,33%,4,5,-1
204,25,16,9,9,77%,109,23%,1,1,0
204,35,37,7,-2,59%,130,38%,5,2,3
204,36,38,8,-2,70%,136,25%,5,2,3
204,32,31,15,1,77%,130,13%,11,4,7
204,40,47,8,-7,55%,139,37%,3,8,-5
204,21,12,21,9,90%,150,19%,2,2,0
204,12,14,7,-2,68%,137,23%,3,3,0
204,38,43,16,-5,72%,135,27%,4,4,0
205,27,13,10,14,80%,131,23%,3,2,1
205,35,33,14,2,69%,135,14%,6,3,3
205,51,56,11,-5,70%,125,19%,11,7,4
205,41,37,12,4,66%,133,21%,3,4,-1
205,33,35,14,-2,77%,135,23%,5,9,-4
205,33,41,5,-8,55%,126,27%,11,13,-2
205,28,26,17,2,71%,154,24%,6,3,3
205,18,21,4,-3,69%,141,36%,5,4,1
205,30,28,7,2,76%,130,13%,7,8,-1
206,47,36,27,11,78%,130,34%,1,4,-3
206,35,32,6,3,70%,141,19%,1,0,1
206,26,30,4,-4,63%,122,33%,5,6,-1
206,15,11,3,4,79%,133,48%,2,2,0
206,43,39,28,4,75%,129,22%,3,5,-2
206,23,29,2,-6,67%,138,23%,6,7,-1
206,26,29,5,-3,61%,140,14%,3,6,-3
206,12,10,4,2,88%,131,27%,2,2,0
207,15,18,6,-3,68%,127,39%,2,3,-1
207,54,53,5,1,67%,129,44%,4,8,-4
207,23,31,6,-8,60%,132,23%,3,2,1
207,11,16,7,-5,62%,167,27%,1,2,-1
207,12,13,1,-1,65%,137,31%,0,0,0
207,36,28,17,8,82%,139,34%,5,1,4
208,31,25,4,6,78%,129,16%,8,6,2
208,31,26,7,5,69%,131,26%,4,6,-2
208,52,45,27,7,72%,140,28%,5,4,1
208,29,23,8,6,83%,139,33%,9,1,8
208,25,17,14,8,74%,142,17%,3,3,0
208,31,37,7,-6,68%,131,45%,5,7,-2
208,17,20,8,-3,74%,148,29%,1,2,-1
209,30,35,8,-5,64%,140,22%,3,9,-6
209,37,24,13,13,77%,126,28%,3,3,0
209,43,41,7,2,69%,136,31%,14,11,3
209,27,33,8,-6,59%,135,33%,4,8,-4
209,52,63,18,-11,62%,141,22%,11,18,-7
209,56,45,22,11,78%,146,27%,4,2,2
209,30,29,14,1,77%,136,34%,6,2,4
209,26,25,8,1,82%,144,33%,5,3,2
209,12,17,4,-5,78%,135,17%,1,1,0
210,31,25,13,6,68%,142,33%,3,4,-1
210,42,35,19,7,72%,151,32%,4,8,-4
210,27,32,14,-5,63%,135,30%,5,7,-2
210,40,35,10,5,74%,132,29%,6,2,4
211,30,28,8,2,66%,140,31%,6,2,4
211,43,47,11,-4,62%,143,27%,6,11,-5
211,27,37,7,-10,63%,133,21%,3,2,1
211,55,50,16,5,69%,139,25%,12,5,7
211,19,17,1,2,63%,130,31%,3,3,0
211,27,23,11,4,71%,137,39%,3,4,-1
211,26,31,8,-5,72%,143,37%,1,3,-2
211,16,14,1,2,56%,110,26%,2,2,0
211,31,40,20,-9,64%,137,19%,5,6,-1
211,40,39,25,1,69%,132,45%,6,3,3
212,35,39,9,-4,62%,145,29%,13,9,4
212,32,30,20,2,80%,149,33%,2,5,-3
212,29,31,10,-2,75%,137,36%,3,4,-1
212,61,60,17,1,68%,131,47%,13,1,12
212,45,42,17,3,68%,142,21%,10,7,3
212,47,44,11,3,73%,131,40%,4,10,-6
212,41,29,8,12,83%,137,34%,5,4,1
212,25,15,11,10,90%,155,24%,2,2,0
212,49,50,15,-1,74%,132,20%,10,6,4
213,32,24,1,8,73%,144,35%,3,4,-1
213,26,31,12,-5,69%,136,32%,6,2,4
213,30,37,15,-7,67%,153,32%,3,1,2
213,25,15,8,10,87%,138,22%,4,1,3
213,47,50,24,-3,72%,138,23%,6,5,1
213,35,26,5,9,80%,139,38%,1,1,0
213,36,40,28,-4,85%,145,29%,5,2,3
213,33,35,4,-2,56%,148,35%,2,7,-5
213,26,32,8,-6,57%,136,29%,1,5,-4
213,16,6,2,10,89%,144,17%,2,2,0
213,29,19,7,10,73%,123,18%,3,2,1
213,33,29,4,4,57%,123,16%,6,9,-3
213,28,28,14,0,76%,133,32%,5,4,1
214,25,23,7,2,71%,141,35%,5,2,3
214,49,48,17,1,70%,142,37%,8,5,3
214,11,14,3,-3,69%,141,24%,5,3,2
215,32,29,12,3,78%,129,31%,2,3,-1
215,36,28,11,8,79%,149,36%,7,8,-1
215,31,25,16,6,76%,138,27%,3,4,-1
215,19,18,7,1,67%,138,39%,3,3,0
215,33,34,9,-1,70%,147,21%,5,5,0
215,39,41,35,-2,76%,144,19%,8,5,3
215,37,44,12,-7,74%,138,39%,5,6,-1
215,51,49,14,2,65%,143,23%,8,14,-6
215,35,30,17,5,74%,138,26%,6,4,2
216,51,45,9,6,62%,133,13%,11,10,1
216,18,12,6,6,86%,143,35%,4,0,4
216,18,19,2,-1,63%,141,28%,3,2,1
216,46,40,20,6,73%,150,26%,7,6,1
216,55,49,19,6,64%,145,30%,13,7,6
216,43,46,18,-3,73%,153,24%,7,3,4
216,43,38,7,5,70%,135,32%,4,5,-1
217,56,56,28,0,79%,149,20%,3,1,2
217,50,50,9,0,67%,143,26%,16,12,4
217,48,46,23,2,74%,142,29%,8,5,3
217,37,32,10,5,70%,144,18%,6,3,3
217,27,16,8,11,87%,155,37%,0,2,-2
217,38,31,17,7,81%,153,37%,3,0,3
218,39,32,20,7,76%,139,21%,3,4,-1
218,47,48,11,-1,70%,153,21%,13,4,9
218,24,26,13,-2,64%,148,11%,3,4,-1
218,34,33,8,1,59%,134,27%,13,6,7
218,39,31,23,8,78%,124,17%,10,6,4
219,33,37,7,-4,73%,139,28%,7,8,-1
219,52,46,18,6,72%,135,19%,9,8,1
219,25,14,7,11,77%,137,21%,3,2,1
219,49,44,19,5,75%,151,32%,9,1,8
219,36,25,24,11,78%,142,21%,0,1,-1
219,52,37,9,15,76%,145,15%,9,10,-1
219,10,15,2,-5,56%,150,25%,0,1,-1
220,40,34,7,6,76%,157,26%,8,5,3
220,24,25,9,-1,69%,144,27%,9,5,4
220,53,55,19,-2,75%,143,22%,4,7,-3
220,25,34,7,-9,55%,156,34%,4,3,1
220,37,27,21,10,81%,146,22%,3,4,-1
220,36,32,15,4,70%,146,28%,3,4,-1
220,30,19,11,11,76%,133,22%,5,3,2
220,14,6,3,8,88%,146,24%,1,0,1
220,20,17,5,3,77%,155,17%,1,2,-1
221,51,37,13,14,77%,152,31%,6,7,-1
221,55,45,14,10,76%,145,28%,4,3,1
221,51,46,17,5,77%,142,31%,8,8,0
221,37,39,8,-2,68%,146,26%,7,6,1
221,43,33,7,10,69%,136,25%,3,6,-3
222,50,49,30,1,74%,144,17%,0,6,-6
222,54,48,17,6,70%,154,16%,7,6,1
222,26,20,9,6,79%,138,26%,1,4,-3
222,31,15,15,16,89%,152,39%,3,1,2
222,45,42,16,3,72%,133,19%,8,7,1
222,31,18,23,13,80%,143,22%,1,1,0
222,38,43,8,-5,61%,150,26%,7,7,0
223,32,32,8,0,73%,156,22%,7,4,3
223,47,50,10,-3,60%,153,17%,4,13,-9
223,53,47,15,6,76%,145,31%,10,11,-1
223,50,47,19,3,68%,147,23%,1,2,-1
223,33,26,15,7,86%,158,23%,5,2,3
223,35,32,4,3,61%,140,24%,11,6,5
223,20,17,9,3,77%,147,28%,2,3,-1
223,16,18,1,-2,62%,141,17%,4,5,-1
224,32,22,17,10,78%,151,49%,5,1,4
224,41,35,12,6,72%,141,29%,5,4,1
224,32,31,10,1,79%,139,32%,3,6,-3
224,15,6,3,9,88%,144,31%,1,1,0
225,44,40,13,4,69%,147,46%,3,1,2
225,35,28,29,7,79%,151,15%,3,3,0
225,12,14,7,-2,65%,136,28%,3,0,3
225,46,43,15,3,66%,154,40%,6,5,1
225,29,32,9,-3,76%,139,40%,3,1,2
225,31,23,22,8,79%,165,22%,3,2,1
226,38,39,14,-1,73%,151,33%,4,2,2
226,46,38,18,8,68%,166,24%,2,6,-4
226,28,18,12,10,80%,146,16%,2,2,0
226,32,30,14,2,68%,145,31%,2,2,0
226,58,41,15,17,78%,162,26%,6,7,-1
226,36,36,7,0,57%,146,13%,0,5,-5
226,27,20,3,7,75%,151,45%,6,0,6
226,41,28,13,13,84%,145,29%,8,2,6
226,13,7,8,6,88%,145,34%,2,0,2
226,18,17,7,1,78%,158,35%,2,3,-1
227,45,43,10,2,69%,154,29%,3,4,-1
227,30,35,2,-5,61%,141,21%,8,8,0
227,42,41,11,1,69%,149,25%,12,12,0
227,30,18,6,12,83%,168,31%,4,3,1
227,48,38,17,10,66%,143,28%,4,5,-1
227,44,27,10,17,71%,133,8%,9,9,0
227,50,40,14,10,75%,155,27%,6,8,-2
227,16,12,12,4,79%,132,20%,2,2,0
227,14,10,7,4,78%,162,28%,0,1,-1
227,13,8,8,5,94%,147,27%,1,2,-1
228,52,56,6,-4,55%,159,38%,11,12,-1
228,40,25,8,15,82%,154,23%,5,3,2
228,47,44,16,3,75%,138,29%,6,6,0
228,48,41,9,7,68%,152,18%,4,4,0
228,20,14,12,6,87%,137,35%,3,0,3
229,32,32,6,0,64%,141,21%,4,8,-4
229,40,31,8,9,71%,147,34%,8,5,3
229,52,51,11,1,68%,157,43%,9,13,-4
229,29,35,6,-6,59%,141,33%,3,4,-1
229,33,30,7,3,77%,148,21%,8,5,3
229,18,14,12,4,83%,150,43%,1,2,-1
229,53,44,16,9,70%,144,31%,10,5,5
229,46,40,18,6,70%,134,21%,5,4,1
229,18,12,6,6,73%,143,30%,2,1,1
229,35,23,9,12,89%,146,25%,5,0,5
230,37,29,4,8,77%,155,44%,8,4,4
230,34,28,11,6,63%,145,37%,3,4,-1
230,46,39,17,7,76%,155,31%,7,7,0
230,55,46,11,9,66%,147,27%,10,7,3
230,54,52,10,2,67%,153,30%,9,6,3
230,29,18,7,11,91%,154,32%,4,3,1
230,26,16,5,10,77%,150,25%,6,3,3
230,52,43,28,9,77%,141,13%,9,2,7
230,34,24,7,10,76%,149,28%,7,3,4
230,27,11,8,16,83%,156,18%,4,1,3
230,21,13,7,8,85%,160,29%,1,0,1
231,28,18,16,10,74%,154,20%,1,2,-1
231,33,36,9,-3,70%,149,25%,7,4,3
231,13,7,7,6,88%,159,23%,1,2,-1
232,59,51,8,8,64%,143,24%,5,8,-3
232,46,39,21,7,73%,160,33%,1,6,-5
232,44,37,7,7,74%,147,28%,12,7,5
233,56,55,7,1,67%,149,28%,9,13,-4
233,29,18,11,11,76%,148,21%,1,2,-1
233,39,32,31,7,77%,150,23%,3,1,2
233,23,28,11,-5,74%,153,25%,3,1,2
233,32,23,12,9,76%,154,32%,6,7,-1
234,42,37,15,5,70%,157,28%,14,11,3
234,32,31,8,1,62%,167,39%,3,2,1
234,31,29,7,2,71%,143,23%,2,1,1
234,37,29,4,8,68%,166,43%,6,3,3
234,37,35,12,2,74%,151,27%,14,8,6
235,44,50,14,-6,71%,149,28%,14,10,4
235,31,23,7,8,69%,163,16%,4,6,-2
235,34,38,13,-4,73%,149,22%,5,5,0
235,15,12,3,3,83%,151,24%,3,2,1
236,38,28,6,10,72%,155,27%,5,7,-2
236,48,42,13,6,71%,146,39%,8,7,1
236,50,51,13,-1,68%,158,26%,16,14,2
236,34,23,16,11,88%,161,28%,3,0,3
236,16,9,3,7,83%,155,24%,2,2,0
236,21,18,5,3,77%,154,17%,8,5,3
237,36,37,18,-1,70%,161,29%,5,5,0
237,71,53,11,18,76%,144,30%,9,11,-2
237,38,31,19,7,78%,163,24%,3,1,2
237,60,48,11,12,80%,157,33%,14,10,4
237,52,47,18,5,69%,154,24%,10,10,0
237,59,46,15,13,72%,148,26%,5,6,-1
237,26,17,13,9,79%,141,10%,5,0,5
237,15,7,7,8,100%,139,17%,2,0,2
237,17,15,3,2,71%,158,17%,4,4,0
238,53,40,17,13,83%,150,32%,8,5,3
238,50,46,9,4,69%,162,25%,13,13,0
238,33,23,11,10,76%,153,21%,5,2,3
238,34,33,8,1,66%,153,22%,9,5,4
238,55,59,16,-4,69%,150,21%,20,10,10
238,41,37,21,4,70%,162,19%,3,3,0
238,52,49,23,3,73%,158,23%,14,7,7
238,17,14,11,3,73%,157,18%,3,7,-4
238,18,16,5,2,73%,154,38%,2,2,0
238,41,33,23,8,79%,153,21%,4,5,-1
239,33,31,6,2,61%,148,30%,10,6,4
239,30,32,10,-2,69%,158,19%,5,8,-3
239,40,31,6,9,75%,152,24%,5,4,1
240,45,48,26,-3,75%,158,21%,4,6,-2
240,53,41,8,12,67%,159,18%,6,9,-3
240,37,25,3,12,68%,145,21%,8,8,0
240,38,32,11,6,72%,164,32%,5,1,4
241,21,14,6,7,88%,156,23%,4,3,1
241,31,15,8,16,82%,144,39%,7,3,4
241,39,24,9,15,83%,146,14%,5,2,3
241,46,39,12,7,74%,148,23%,7,7,0
241,20,10,12,10,73%,151,30%,1,2,-1
242,29,14,11,15,94%,161,24%,2,3,-1
242,32,15,7,17,85%,163,36%,3,2,1
242,59,52,9,7,67%,157,31%,10,15,-5
242,37,28,7,9,76%,150,25%,4,6,-2
242,35,28,10,7,73%,169,18%,3,3,0
243,19,8,4,11,79%,143,33%,1,0,1
244,30,19,10,11,71%,153,19%,5,3,2
244,38,31,7,7,69%,156,20%,8,8,0
244,56,48,18,8,73%,160,25%,10,12,-2
245,57,51,16,6,74%,164,25%,13,8,5
245,44,35,14,9,70%,156,26%,4,2,2
245,61,42,15,19,81%,159,33%,6,2,4
245,13,8,11,5,88%,167,34%,1,1,0
245,45,32,7,13,72%,161,29%,5,7,-2
246,38,33,4,5,74%,149,26%,0,3,-3
246,33,25,9,8,68%,168,16%,8,5,3
246,51,45,12,6,68%,150,29%,4,7,-3
246,20,12,5,8,81%,176,38%,1,0,1
246,43,31,16,12,84%,177,35%,5,2,3
246,21,13,7,8,96%,164,25%,2,1,1
247,36,23,10,13,74%,160,27%,6,6,0
247,41,41,6,0,58%,155,22%,8,9,-1
247,54,42,22,12,80%,151,37%,5,4,1
247,60,49,10,11,69%,167,24%,13,9,4
247,38,26,9,12,78%,153,16%,7,0,7
247,36,36,9,0,71%,140,17%,6,6,0
247,19,14,12,5,86%,173,24%,4,1,3
247,18,11,7,7,81%,157,11%,2,1,1
248,58,35,3,23,72%,149,22%,15,11,4
248,49,31,23,18,69%,150,40%,4,4,0
248,53,43,8,10,71%,152,20%,7,6,1
248,19,14,3,5,76%,164,14%,3,6,-3
249,35,37,12,-2,68%,159,18%,4,5,-1
249,35,22,9,13,72%,161,23%,4,1,3
249,29,32,6,-3,63%,156,19%,4,3,1
249,68,43,12,25,76%,158,29%,7,3,4
249,21,17,5,4,77%,161,37%,1,3,-2
249,24,21,2,3,77%,162,24%,2,2,0
250,38,36,18,2,78%,172,26%,4,5,-1
250,16,10,6,6,89%,152,37%,3,0,3
250,30,22,12,8,77%,175,22%,1,5,-4
250,31,14,15,17,88%,172,39%,2,1,1
250,39,40,14,-1,70%,173,30%,7,5,2
251,38,23,8,15,80%,165,34%,4,3,1
251,34,20,23,14,78%,161,25%,3,2,1
251,34,31,11,3,65%,155,31%,3,2,1
251,54,45,8,9,69%,160,29%,13,4,9
251,43,28,12,15,83%,165,19%,7,2,5
251,32,21,5,11,67%,148,18%,9,8,1
251,32,21,9,11,81%,146,38%,3,2,1
251,17,7,5,10,81%,159,45%,1,0,1
251,27,31,16,-4,65%,160,17%,2,5,-3
251,25,12,5,13,85%,161,34%,3,1,2
252,29,18,11,11,86%,145,22%,6,2,4
252,14,14,12,0,81%,186,24%,3,1,2
252,60,48,9,12,77%,165,30%,14,11,3
252,21,19,8,2,62%,177,34%,4,3,1
253,55,40,11,15,74%,171,38%,4,5,-1
253,54,36,18,18,83%,167,26%,3,3,0
254,37,35,9,2,77%,169,26%,7,9,-2
254,43,36,14,7,73%,163,32%,6,2,4
254,34,21,17,13,87%,168,34%,3,2,1
254,61,56,13,5,69%,158,27%,15,12,3
255,51,32,19,19,84%,158,22%,9,5,4
255,51,42,14,9,72%,166,38%,8,3,5
255,15,15,4,0,76%,171,20%,1,1,0
256,31,26,5,5,67%,173,24%,4,4,0
256,38,26,6,12,76%,169,22%,6,3,3
256,36,25,9,11,71%,163,27%,6,2,4
256,43,35,10,8,79%,161,24%,14,7,7
257,32,19,8,13,82%,166,31%,8,1,7
257,58,38,17,20,75%,162,24%,5,2,3
257,57,43,9,14,82%,165,52%,10,9,1
258,43,32,16,11,74%,168,13%,2,4,-2
258,41,23,15,18,74%,174,19%,3,5,-2
259,52,36,14,16,76%,155,29%,3,2,1
259,33,22,16,11,86%,152,22%,4,2,2
259,37,30,7,7,67%,168,26%,3,7,-4
259,36,30,11,6,85%,173,15%,9,5,4
259,18,13,9,5,71%,174,43%,1,1,0
260,43,33,8,10,72%,166,20%,6,7,-1
260,21,17,7,4,75%,191,26%,3,0,3
260,49,36,17,13,75%,175,33%,2,9,-7
260,18,9,5,9,79%,167,19%,2,0,2
261,54,33,13,21,86%,168,29%,12,4,8
261,45,31,7,14,79%,174,23%,11,4,7
262,27,29,7,-2,69%,175,22%,3,9,-6
262,40,26,5,14,84%,160,28%,11,5,6
262,51,51,11,0,68%,162,26%,6,10,-4
262,20,15,2,5,67%,156,24%,3,4,-1
263,15,13,15,2,94%,189,17%,3,0,3
263,32,19,11,13,84%,169,33%,2,2,0
264,73,49,11,24,75%,167,22%,15,7,8
264,47,29,20,18,81%,163,14%,1,2,-1
265,37,16,13,21,92%,169,34%,3,0,3
265,17,13,4,4,68%,165,38%,1,0,1
265,16,15,14,1,76%,180,21%,0,4,-4
266,37,31,4,6,70%,172,42%,7,7,0
267,52,40,15,12,73%,187,29%,13,8,5
268,42,28,7,14,68%,164,32%,6,2,4
268,52,42,10,10,75%,177,26%,10,6,4
269,43,40,10,3,72%,166,22%,13,5,8
269,23,15,6,8,79%,173,23%,2,1,1
269,45,37,17,8,74%,170,18%,6,6,0
269,60,44,8,16,70%,165,25%,18,16,2
269,38,27,10,11,73%,161,20%,3,3,0
270,43,31,30,12,91%,160,28%,7,1,6
270,51,36,28,15,75%,179,26%,2,3,-1
270,62,47,18,15,71%,167,24%,7,8,-1
270,15,15,11,0,89%,173,21%,2,0,2
272,51,35,13,16,80%,179,37%,11,7,4
272,66,43,10,23,74%,166,30%,18,4,14
272,41,28,13,13,79%,169,43%,4,3,1
273,41,29,10,12,85%,176,26%,12,4,8
273,35,13,7,22,85%,171,21%,7,4,3
274,35,18,11,17,80%,192,24%,4,0,4
274,58,45,11,13,77%,183,28%,6,3,3
274,16,8,9,8,87%,184,24%,3,0,3
275,41,32,19,9,82%,176,29%,1,6,-5
276,40,23,15,17,78%,181,25%,3,4,-1
276,51,31,23,20,80%,159,34%,12,0,12
276,21,16,1,5,74%,148,37%,4,2,2
276,27,19,4,8,65%,169,35%,7,7,0
276,21,12,15,9,81%,159,29%,1,0,1
277,65,42,6,23,80%,170,25%,16,9,7
278,21,16,0,5,68%,157,14%,8,3,5
278,37,17,15,20,94%,182,51%,3,1,2
278,21,18,2,3,67%,175,41%,4,1,3
279,40,26,4,14,82%,183,24%,15,3,12
279,47,35,7,12,66%,184,29%,11,10,1
280,40,26,20,14,88%,187,22%,2,3,-1
280,45,36,6,9,74%,178,34%,10,9,1
280,29,16,11,13,87%,172,27%,4,3,1
281,53,46,12,7,75%,167,20%,12,9,3
281,41,25,13,16,78%,174,26%,2,2,0
285,44,32,9,12,77%,180,32%,9,4,5
285,20,11,5,9,94%,166,28%,3,0,3
286,50,31,14,19,69%,175,28%,7,11,-4
286,40,24,10,16,78%,191,23%,6,2,4
286,33,17,16,16,91%,193,38%,5,3,2
287,71,49,18,22,80%,177,24%,14,7,7
287,64,51,22,13,75%,192,29%,10,9,1
287,63,40,8,23,75%,186,24%,20,6,14
288,41,25,7,16,73%,191,29%,8,3,5
288,52,34,21,18,80%,188,30%,7,5,2
289,53,44,5,9,65%,180,34%,16,7,9
289,37,21,6,16,78%,183,28%,14,3,11
290,42,33,8,9,77%,171,32%,11,10,1
291,19,5,4,14,88%,188,24%,7,1,6
292,40,24,6,16,81%,214,31%,6,0,6
293,46,27,6,19,70%,184,34%,10,5,5
293,50,34,20,16,82%,192,20%,4,3,1
294,39,21,7,18,83%,189,28%,9,5,4
295,38,26,7,12,74%,180,29%,10,3,7
296,51,35,10,16,71%,191,45%,9,8,1
296,20,18,4,2,62%,174,16%,5,2,3
297,19,7,4,12,88%,175,25%,5,1,4
297,20,10,6,10,84%,187,19%,2,1,1
301,20,9,6,11,94%,189,14%,2,0,2
302,37,20,8,17,82%,212,38%,8,1,7
303,38,21,7,17,83%,206,33%,6,3,3
304,69,49,9,20,73%,181,38%,10,5,5
305,43,31,4,12,72%,184,31%,10,6,4
306,35,17,4,18,80%,184,41%,8,4,4
306,20,8,3,12,94%,202,19%,6,0,6
307,25,18,9,7,78%,195,26%,1,1,0
308,57,40,11,17,72%,204,23%,16,7,9
309,47,26,6,21,78%,204,35%,13,3,10
309,18,7,6,11,100%,207,26%,3,1,2
310,48,32,28,16,83%,200,18%,5,6,-1
311,51,45,13,6,74%,197,20%,10,6,4
312,38,18,9,20,80%,195,35%,9,1,8
312,34,16,15,18,94%,200,17%,4,2,2
315,22,15,1,7,58%,213,37%,0,1,-1
315,18,9,5,9,81%,184,14%,5,4,1
316,23,15,6,8,68%,168,17%,6,1,5
316,58,40,10,18,75%,197,29%,10,10,0
316,18,3,0,15,100%,182,16%,4,0,4
318,40,19,22,21,94%,210,26%,8,2,6
320,21,15,4,6,74%,191,18%,4,0,4
326,57,39,7,18,76%,199,29%,12,11,1
327,26,14,1,12,76%,189,20%,9,4,5
327,39,20,7,19,79%,213,22%,10,3,7
333,41,15,3,26,83%,188,14%,5,3,2
335,24,11,9,13,89%,196,24%,2,1,1
335,21,15,4,6,79%,209,30%,9,2,7
335,41,20,9,21,82%,225,25%,13,3,10
338,46,24,15,22,85%,207,33%,3,2,1
339,50,19,16,31,87%,214,37%,3,2,1
339,26,17,4,9,86%,197,24%,13,2,11
340,19,9,5,10,94%,199,20%,1,0,1
341,49,20,7,29,92%,222,34%,8,2,6
341,35,18,15,17,87%,220,15%,6,1,5
342,43,21,9,22,89%,211,20%,9,2,7
344,25,14,1,11,84%,225,35%,3,1,2
346,21,12,8,9,94%,239,40%,3,2,1
348,35,16,10,19,90%,219,18%,10,2,8
349,28,21,6,7,87%,228,21%,6,2,4
350,24,8,7,16,83%,205,22%,5,2,3
351,59,31,6,28,79%,216,31%,11,7,4
357,30,15,3,15,87%,237,35%,0,1,-1
363,55,26,11,29,81%,242,42%,7,5,2
363,22,11,2,11,69%,219,30%,4,1,3
365,23,10,0,13,82%,232,26%,5,2,3
366,21,14,1,7,81%,219,50%,2,1,1
367,26,8,3,18,74%,225,14%,3,1,2
373,24,9,0,15,88%,238,51%,1,0,1
373,51,25,6,26,84%,242,30%,8,5,3
381,50,20,6,30,73%,225,30%,13,4,9
406,25,13,3,12,82%,245,34%,6,1,5